inventory_key,product_key,date_key,location_key,stock_level,stock_in,stock_out,created_at
1,109,2023-01-14,3,6,57,51,2025-07-23 23:42:36.218821
2,19,2023-09-27,231,235,406,171,2025-07-23 23:42:36.220056
3,318,2023-02-26,37,29,132,103,2025-07-23 23:42:36.221201
4,823,2023-12-13,118,213,295,82,2025-07-23 23:42:36.222346
5,1360,2022-09-02,11,5,47,42,2025-07-23 23:42:36.223455
6,575,2023-12-23,133,251,326,75,2025-07-23 23:42:36.224548
7,1399,2022-04-26,102,149,455,306,2025-07-23 23:42:36.225671
8,284,2022-09-12,43,76,146,70,2025-07-23 23:42:36.226831
9,1218,2023-08-29,138,16,101,85,2025-07-23 23:42:36.228059
10,1415,2023-01-07,250,212,250,38,2025-07-23 23:42:36.230347
11,1112,2022-09-07,15,7,31,24,2025-07-23 23:42:36.231473
12,1117,2022-07-18,2,27,34,7,2025-07-23 23:42:36.232534
13,498,2024-04-28,11,191,381,190,2025-07-23 23:42:36.233658
14,803,2022-10-02,42,90,248,158,2025-07-23 23:42:36.234783
15,1016,2023-11-08,204,39,414,375,2025-07-23 23:42:36.235883
16,211,2024-10-27,185,252,402,150,2025-07-23 23:42:36.237038
17,681,2024-04-06,119,29,91,62,2025-07-23 23:42:36.238115
18,1078,2023-09-23,60,62,170,108,2025-07-23 23:42:36.239172
19,973,2023-05-21,235,37,187,150,2025-07-23 23:42:36.240245
20,72,2024-08-09,14,227,254,27,2025-07-23 23:42:36.241361
21,106,2023-03-07,205,29,452,423,2025-07-23 23:42:36.242417
22,1048,2023-09-05,206,309,405,96,2025-07-23 23:42:36.243492
23,42,2022-08-22,82,56,390,334,2025-07-23 23:42:36.244572
24,804,2022-12-14,63,78,191,113,2025-07-23 23:42:36.245697
25,29,2023-02-02,225,22,52,30,2025-07-23 23:42:36.246805
26,356,2024-10-05,243,38,320,282,2025-07-23 23:42:36.247859
27,629,2022-12-30,202,260,401,141,2025-07-23 23:42:36.249088
28,1311,2022-01-11,137,68,364,296,2025-07-23 23:42:36.250215
29,620,2024-08-20,134,390,463,73,2025-07-23 23:42:36.251276
30,593,2022-11-02,225,280,354,74,2025-07-23 23:42:36.252350
31,1232,2022-07-30,72,441,494,53,2025-07-23 23:42:36.253432
32,796,2024-06-22,54,19,28,9,2025-07-23 23:42:36.254541
33,19,2023-04-10,189,343,460,117,2025-07-23 23:42:36.255616
34,1418,2023-08-06,130,164,303,139,2025-07-23 23:42:36.257832
35,606,2024-02-20,159,116,470,354,2025-07-23 23:42:36.258946
36,983,2024-04-02,203,43,53,10,2025-07-23 23:42:36.260016
37,1128,2023-04-16,223,90,177,87,2025-07-23 23:42:36.261123
38,156,2023-01-13,204,8,26,18,2025-07-23 23:42:36.262193
39,812,2024-12-18,135,67,74,7,2025-07-23 23:42:36.263285
40,91,2024-07-23,27,123,212,89,2025-07-23 23:42:36.264391
41,531,2024-10-12,105,144,168,24,2025-07-23 23:42:36.265518
42,255,2022-02-01,77,14,421,407,2025-07-23 23:42:36.266560
43,1419,2022-02-19,114,351,358,7,2025-07-23 23:42:36.267656
44,1143,2023-10-01,208,24,75,51,2025-07-23 23:42:36.268750
45,133,2024-12-28,204,95,166,71,2025-07-23 23:42:36.269850
46,977,2024-03-23,5,168,296,128,2025-07-23 23:42:36.270977
47,1085,2023-10-28,22,177,476,299,2025-07-23 23:42:36.272062
48,902,2023-08-12,65,19,87,68,2025-07-23 23:42:36.273138
49,1199,2023-11-28,57,294,310,16,2025-07-23 23:42:36.274223
50,249,2024-11-26,189,43,161,118,2025-07-23 23:42:36.275397
51,155,2023-06-22,133,163,241,78,2025-07-23 23:42:36.276460
52,1067,2024-01-16,75,24,29,5,2025-07-23 23:42:36.277643
53,1459,2024-06-30,161,23,70,47,2025-07-23 23:42:36.278722
54,450,2023-03-23,146,80,145,65,2025-07-23 23:42:36.279989
55,813,2023-05-30,25,243,402,159,2025-07-23 23:42:36.284041
56,112,2022-09-08,11,21,32,11,2025-07-23 23:42:36.285228
57,920,2024-12-13,68,2,394,392,2025-07-23 23:42:36.286341
58,182,2024-11-13,88,37,54,17,2025-07-23 23:42:36.287439
59,54,2022-04-28,79,200,380,180,2025-07-23 23:42:36.288530
60,152,2023-05-12,164,193,237,44,2025-07-23 23:42:36.289670
61,151,2024-08-05,222,0,105,105,2025-07-23 23:42:36.291151
62,261,2023-07-03,161,7,29,22,2025-07-23 23:42:36.292296
63,1253,2023-11-27,1,475,483,8,2025-07-23 23:42:36.293427
64,71,2024-05-27,9,5,193,188,2025-07-23 23:42:36.294543
65,604,2022-03-05,9,187,281,94,2025-07-23 23:42:36.295600
66,1079,2023-02-20,65,387,492,105,2025-07-23 23:42:36.296669
67,1368,2024-04-11,181,11,112,101,2025-07-23 23:42:36.297831
68,689,2023-09-03,133,86,252,166,2025-07-23 23:42:36.298895
69,442,2024-11-12,193,5,257,252,2025-07-23 23:42:36.299961
70,1273,2022-06-10,84,50,323,273,2025-07-23 23:42:36.301075
71,201,2024-05-22,57,86,201,115,2025-07-23 23:42:36.302217
72,739,2023-03-28,244,24,35,11,2025-07-23 23:42:36.303341
73,848,2023-09-11,170,11,100,89,2025-07-23 23:42:36.304426
74,445,2024-11-07,36,197,286,89,2025-07-23 23:42:36.305562
75,558,2023-02-02,73,240,369,129,2025-07-23 23:42:36.306628
76,893,2022-05-22,236,2,11,9,2025-07-23 23:42:36.307721
77,537,2024-10-29,153,115,477,362,2025-07-23 23:42:36.308869
78,1064,2022-01-28,12,389,405,16,2025-07-23 23:42:36.309981
79,16,2024-10-15,59,5,78,73,2025-07-23 23:42:36.311127
80,568,2022-09-14,9,31,349,318,2025-07-23 23:42:36.312209
81,1091,2022-11-07,149,1,68,67,2025-07-23 23:42:36.313325
82,93,2024-03-07,174,10,107,97,2025-07-23 23:42:36.314443
83,1311,2022-05-05,183,87,117,30,2025-07-23 23:42:36.315564
84,1318,2024-10-04,55,20,99,79,2025-07-23 23:42:36.316563
85,44,2023-02-04,88,264,396,132,2025-07-23 23:42:36.317469
86,652,2024-02-15,37,37,85,48,2025-07-23 23:42:36.318362
87,645,2023-09-07,148,105,111,6,2025-07-23 23:42:36.319269
88,93,2022-08-22,177,33,117,84,2025-07-23 23:42:36.320235
89,1298,2022-04-25,58,387,468,81,2025-07-23 23:42:36.321143
90,286,2023-12-01,142,228,479,251,2025-07-23 23:42:36.322083
91,1468,2022-12-29,6,15,34,19,2025-07-23 23:42:36.323108
92,1161,2022-09-23,192,131,475,344,2025-07-23 23:42:36.324074
93,960,2022-12-18,31,308,326,18,2025-07-23 23:42:36.324935
94,1445,2024-10-28,75,160,362,202,2025-07-23 23:42:36.325787
95,465,2023-04-18,156,221,472,251,2025-07-23 23:42:36.326629
96,800,2022-02-23,139,54,278,224,2025-07-23 23:42:36.327488
97,563,2022-08-23,68,217,304,87,2025-07-23 23:42:36.328358
98,510,2023-11-11,131,257,385,128,2025-07-23 23:42:36.329263
99,1421,2024-12-28,221,64,496,432,2025-07-23 23:42:36.330139
100,805,2022-02-25,135,217,310,93,2025-07-23 23:42:36.330988
101,646,2022-09-29,143,81,89,8,2025-07-23 23:42:36.331843
102,1080,2024-04-01,14,115,202,87,2025-07-23 23:42:36.332686
103,1384,2023-08-03,131,30,164,134,2025-07-23 23:42:36.333555
104,1134,2024-02-17,72,111,395,284,2025-07-23 23:42:36.334447
105,1292,2023-04-03,22,241,480,239,2025-07-23 23:42:36.335314
106,1039,2024-10-10,14,22,95,73,2025-07-23 23:42:36.336238
107,755,2024-12-07,109,206,352,146,2025-07-23 23:42:36.337266
108,1253,2024-01-03,226,55,100,45,2025-07-23 23:42:36.338346
109,110,2022-07-29,29,57,83,26,2025-07-23 23:42:36.339445
110,1276,2024-09-08,1,47,208,161,2025-07-23 23:42:36.340519
111,1435,2024-11-23,5,408,465,57,2025-07-23 23:42:36.341654
112,55,2023-12-23,183,12,24,12,2025-07-23 23:42:36.343912
113,445,2022-06-07,202,284,427,143,2025-07-23 23:42:36.345065
114,44,2023-09-03,135,10,72,62,2025-07-23 23:42:36.346135
115,27,2023-05-29,207,52,57,5,2025-07-23 23:42:36.347262
116,1267,2024-02-27,68,14,63,49,2025-07-23 23:42:36.348360
117,1014,2024-10-07,166,440,458,18,2025-07-23 23:42:36.349470
118,1004,2024-05-13,93,311,382,71,2025-07-23 23:42:36.350577
119,1333,2024-04-20,49,189,422,233,2025-07-23 23:42:36.351664
120,747,2022-06-12,108,5,457,452,2025-07-23 23:42:36.352656
121,1492,2022-12-30,88,286,355,69,2025-07-23 23:42:36.353378
122,1372,2024-05-04,1,359,405,46,2025-07-23 23:42:36.354131
123,834,2022-12-03,123,61,149,88,2025-07-23 23:42:36.354742
124,500,2024-08-08,117,48,221,173,2025-07-23 23:42:36.355491
125,794,2024-02-06,52,183,436,253,2025-07-23 23:42:36.356438
126,632,2022-02-15,219,155,251,96,2025-07-23 23:42:36.357436
127,1385,2023-10-24,127,120,287,167,2025-07-23 23:42:36.358463
128,57,2022-08-23,93,22,28,6,2025-07-23 23:42:36.359347
129,668,2023-01-22,212,82,444,362,2025-07-23 23:42:36.360218
130,792,2023-05-18,159,94,105,11,2025-07-23 23:42:36.361073
131,1359,2024-06-17,163,36,63,27,2025-07-23 23:42:36.361949
132,1420,2023-11-10,243,228,348,120,2025-07-23 23:42:36.362783
133,1205,2022-12-10,154,48,365,317,2025-07-23 23:42:36.363738
134,420,2024-09-17,208,33,96,63,2025-07-23 23:42:36.364785
135,465,2024-01-08,152,101,139,38,2025-07-23 23:42:36.365849
136,538,2022-05-26,111,86,343,257,2025-07-23 23:42:36.366874
137,79,2023-08-28,240,61,242,181,2025-07-23 23:42:36.367937
138,295,2023-10-06,173,403,496,93,2025-07-23 23:42:36.368997
139,658,2022-09-20,250,72,295,223,2025-07-23 23:42:36.369900
140,813,2024-06-10,233,130,148,18,2025-07-23 23:42:36.370790
141,1273,2023-11-22,64,380,420,40,2025-07-23 23:42:36.371653
142,542,2022-10-10,55,20,27,7,2025-07-23 23:42:36.372594
143,1481,2024-05-08,104,13,251,238,2025-07-23 23:42:36.373481
144,566,2022-10-14,201,421,498,77,2025-07-23 23:42:36.374403
145,1423,2022-05-06,193,95,283,188,2025-07-23 23:42:36.375309
146,1147,2023-11-28,242,122,150,28,2025-07-23 23:42:36.376192
147,27,2024-04-09,162,7,122,115,2025-07-23 23:42:36.377093
148,1163,2022-06-19,50,43,341,298,2025-07-23 23:42:36.377994
149,672,2023-12-22,107,67,118,51,2025-07-23 23:42:36.378936
150,628,2023-11-05,141,104,118,14,2025-07-23 23:42:36.379803
151,706,2024-07-18,176,79,330,251,2025-07-23 23:42:36.380665
152,1069,2022-07-24,170,99,386,287,2025-07-23 23:42:36.381983
153,1193,2024-12-18,209,197,268,71,2025-07-23 23:42:36.383203
154,1249,2024-06-19,154,22,291,269,2025-07-23 23:42:36.384282
155,940,2023-09-05,29,250,372,122,2025-07-23 23:42:36.385290
156,794,2024-08-08,177,218,434,216,2025-07-23 23:42:36.386194
157,282,2023-04-30,210,86,92,6,2025-07-23 23:42:36.387073
158,1347,2024-06-28,45,163,358,195,2025-07-23 23:42:36.387942
159,439,2022-04-21,112,167,272,105,2025-07-23 23:42:36.388848
160,288,2022-07-15,126,130,150,20,2025-07-23 23:42:36.389706
161,1402,2023-02-15,214,210,219,9,2025-07-23 23:42:36.390578
162,1257,2023-06-23,203,295,489,194,2025-07-23 23:42:36.391484
163,1375,2022-03-22,81,213,299,86,2025-07-23 23:42:36.392417
164,597,2023-01-09,190,85,353,268,2025-07-23 23:42:36.393461
165,561,2024-08-04,183,197,218,21,2025-07-23 23:42:36.394589
166,18,2024-01-13,219,74,162,88,2025-07-23 23:42:36.395664
167,188,2022-11-27,5,24,230,206,2025-07-23 23:42:36.396808
168,340,2022-09-14,98,30,348,318,2025-07-23 23:42:36.397886
169,938,2022-05-05,40,169,271,102,2025-07-23 23:42:36.398995
170,287,2023-08-12,19,45,149,104,2025-07-23 23:42:36.400061
171,1156,2023-03-29,94,123,401,278,2025-07-23 23:42:36.401154
172,286,2024-03-19,38,25,91,66,2025-07-23 23:42:36.402232
173,770,2022-11-03,116,32,115,83,2025-07-23 23:42:36.403377
174,687,2024-01-27,90,231,469,238,2025-07-23 23:42:36.404484
175,1353,2022-05-23,33,188,417,229,2025-07-23 23:42:36.405566
176,1196,2022-03-15,90,134,221,87,2025-07-23 23:42:36.406646
177,924,2024-05-01,45,13,254,241,2025-07-23 23:42:36.407833
178,388,2022-11-11,148,254,268,14,2025-07-23 23:42:36.409010
179,831,2022-08-30,102,27,284,257,2025-07-23 23:42:36.410124
180,1462,2024-09-06,105,159,412,253,2025-07-23 23:42:36.411237
181,1380,2023-06-20,208,35,499,464,2025-07-23 23:42:36.412415
182,453,2023-07-01,104,28,260,232,2025-07-23 23:42:36.413552
183,560,2024-09-19,42,154,397,243,2025-07-23 23:42:36.414641
184,412,2023-11-01,122,89,326,237,2025-07-23 23:42:36.415721
185,1125,2022-10-14,250,187,251,64,2025-07-23 23:42:36.416858
186,13,2023-03-01,21,361,475,114,2025-07-23 23:42:36.417929
187,427,2023-09-04,124,343,407,64,2025-07-23 23:42:36.419039
188,843,2023-04-02,8,4,52,48,2025-07-23 23:42:36.420112
189,35,2022-06-24,145,73,99,26,2025-07-23 23:42:36.421146
190,59,2023-10-11,154,48,373,325,2025-07-23 23:42:36.422304
191,1081,2023-03-23,90,240,262,22,2025-07-23 23:42:36.423396
192,357,2024-01-03,80,6,116,110,2025-07-23 23:42:36.424492
193,307,2023-04-01,124,57,319,262,2025-07-23 23:42:36.425554
194,262,2023-10-03,247,346,453,107,2025-07-23 23:42:36.426622
195,696,2024-03-01,60,34,176,142,2025-07-23 23:42:36.427717
196,484,2024-02-05,196,35,175,140,2025-07-23 23:42:36.428854
197,1249,2024-12-18,208,21,26,5,2025-07-23 23:42:36.429981
198,1120,2022-05-10,193,6,62,56,2025-07-23 23:42:36.431083
199,87,2024-03-08,159,300,424,124,2025-07-23 23:42:36.432193
200,1468,2024-10-12,40,55,460,405,2025-07-23 23:42:36.433254
201,605,2022-12-19,147,44,81,37,2025-07-23 23:42:36.434579
202,920,2024-07-21,63,166,395,229,2025-07-23 23:42:36.435747
203,1453,2022-11-19,158,213,403,190,2025-07-23 23:42:36.436889
204,605,2023-11-23,23,101,182,81,2025-07-23 23:42:36.437980
205,718,2022-03-01,30,31,73,42,2025-07-23 23:42:36.439104
206,1011,2024-08-05,101,0,196,196,2025-07-23 23:42:36.440150
207,868,2022-10-24,108,192,206,14,2025-07-23 23:42:36.441083
208,1412,2023-05-23,26,265,359,94,2025-07-23 23:42:36.441969
209,386,2022-08-19,83,54,146,92,2025-07-23 23:42:36.442889
210,1155,2022-04-19,19,19,35,16,2025-07-23 23:42:36.443809
211,383,2023-10-14,44,227,467,240,2025-07-23 23:42:36.444794
212,825,2022-11-05,231,72,86,14,2025-07-23 23:42:36.445693
213,794,2022-08-25,66,288,403,115,2025-07-23 23:42:36.446612
214,508,2022-01-25,44,58,472,414,2025-07-23 23:42:36.447524
215,757,2023-02-06,13,47,111,64,2025-07-23 23:42:36.448569
216,13,2023-07-03,125,53,96,43,2025-07-23 23:42:36.449524
217,110,2024-04-23,186,369,419,50,2025-07-23 23:42:36.450512
218,200,2024-11-06,93,163,168,5,2025-07-23 23:42:36.451557
219,855,2022-12-08,206,106,191,85,2025-07-23 23:42:36.452532
220,1316,2024-12-16,78,178,204,26,2025-07-23 23:42:36.453515
221,427,2022-05-05,126,197,273,76,2025-07-23 23:42:36.454587
222,722,2024-06-10,21,165,228,63,2025-07-23 23:42:36.455656
223,1269,2023-01-14,37,277,496,219,2025-07-23 23:42:36.456738
224,717,2022-07-20,37,5,68,63,2025-07-23 23:42:36.457876
225,107,2024-01-20,145,0,35,35,2025-07-23 23:42:36.460086
226,1326,2023-03-02,46,256,499,243,2025-07-23 23:42:36.461260
227,1221,2023-09-25,46,56,181,125,2025-07-23 23:42:36.462337
228,741,2022-03-14,168,54,303,249,2025-07-23 23:42:36.463415
229,1341,2023-05-29,22,110,250,140,2025-07-23 23:42:36.464552
230,784,2023-09-20,158,42,67,25,2025-07-23 23:42:36.465677
231,1260,2023-10-01,126,7,43,36,2025-07-23 23:42:36.466731
232,558,2024-06-27,162,150,193,43,2025-07-23 23:42:36.467851
233,165,2023-11-09,52,118,232,114,2025-07-23 23:42:36.469176
234,455,2023-08-10,244,277,442,165,2025-07-23 23:42:36.470265
235,791,2024-04-27,11,161,419,258,2025-07-23 23:42:36.471358
236,755,2022-07-30,145,99,116,17,2025-07-23 23:42:36.472422
237,162,2023-07-25,47,17,100,83,2025-07-23 23:42:36.473533
238,1204,2023-10-08,223,196,228,32,2025-07-23 23:42:36.474603
239,235,2023-04-13,200,398,408,10,2025-07-23 23:42:36.475750
240,462,2024-08-18,241,41,119,78,2025-07-23 23:42:36.476887
241,1378,2024-11-17,217,17,22,5,2025-07-23 23:42:36.477922
242,1354,2024-04-22,89,379,400,21,2025-07-23 23:42:36.479101
243,1171,2022-04-17,69,84,250,166,2025-07-23 23:42:36.480202
244,1498,2023-05-05,1,81,121,40,2025-07-23 23:42:36.481259
245,328,2024-11-25,116,11,434,423,2025-07-23 23:42:36.482320
246,1439,2023-10-19,127,232,363,131,2025-07-23 23:42:36.483536
247,1376,2023-05-30,4,147,200,53,2025-07-23 23:42:36.484808
248,1326,2023-07-03,220,68,79,11,2025-07-23 23:42:36.485887
249,482,2023-04-23,54,187,219,32,2025-07-23 23:42:36.486953
250,181,2023-01-11,18,252,271,19,2025-07-23 23:42:36.488111
251,517,2024-08-25,178,5,83,78,2025-07-23 23:42:36.489192
252,854,2024-11-26,192,235,255,20,2025-07-23 23:42:36.490246
253,1337,2024-08-12,139,11,25,14,2025-07-23 23:42:36.491325
254,719,2024-12-03,47,13,85,72,2025-07-23 23:42:36.492382
255,1200,2023-09-16,32,30,372,342,2025-07-23 23:42:36.493444
256,968,2024-07-24,83,44,461,417,2025-07-23 23:42:36.494554
257,1144,2023-08-26,125,24,190,166,2025-07-23 23:42:36.495640
258,132,2023-10-18,120,228,322,94,2025-07-23 23:42:36.496656
259,1166,2024-01-26,122,119,137,18,2025-07-23 23:42:36.497750
260,931,2024-01-30,247,445,480,35,2025-07-23 23:42:36.498807
261,74,2023-01-10,203,174,399,225,2025-07-23 23:42:36.499858
262,1089,2023-08-15,142,261,439,178,2025-07-23 23:42:36.500929
263,503,2024-03-16,159,10,350,340,2025-07-23 23:42:36.502006
264,1154,2024-10-11,249,31,51,20,2025-07-23 23:42:36.503106
265,1369,2023-07-14,113,117,365,248,2025-07-23 23:42:36.504327
266,1362,2023-10-02,224,155,164,9,2025-07-23 23:42:36.505665
267,1056,2024-08-14,199,385,411,26,2025-07-23 23:42:36.506743
268,410,2023-11-02,34,379,438,59,2025-07-23 23:42:36.507845
269,491,2023-02-19,171,125,145,20,2025-07-23 23:42:36.508992
270,172,2022-11-24,242,157,324,167,2025-07-23 23:42:36.510055
271,11,2023-05-23,212,102,203,101,2025-07-23 23:42:36.511134
272,626,2022-11-05,91,98,128,30,2025-07-23 23:42:36.512200
273,408,2023-02-07,137,131,148,17,2025-07-23 23:42:36.513280
274,809,2024-12-14,55,252,448,196,2025-07-23 23:42:36.514363
275,311,2022-02-03,157,27,39,12,2025-07-23 23:42:36.515426
276,1475,2022-06-02,167,23,232,209,2025-07-23 23:42:36.516479
277,541,2024-02-04,22,47,60,13,2025-07-23 23:42:36.517530
278,1047,2024-05-24,244,105,111,6,2025-07-23 23:42:36.518630
279,664,2023-09-08,119,249,271,22,2025-07-23 23:42:36.519811
280,1073,2024-01-17,215,3,81,78,2025-07-23 23:42:36.520916
281,1298,2022-08-27,60,140,153,13,2025-07-23 23:42:36.522000
282,1254,2023-08-09,69,309,370,61,2025-07-23 23:42:36.523269
283,1386,2023-10-04,228,63,276,213,2025-07-23 23:42:36.524379
284,541,2024-08-24,162,11,354,343,2025-07-23 23:42:36.525441
285,1217,2023-10-08,217,50,62,12,2025-07-23 23:42:36.526527
286,961,2023-05-08,13,200,252,52,2025-07-23 23:42:36.527641
287,704,2022-05-26,128,113,131,18,2025-07-23 23:42:36.528749
288,492,2022-03-15,236,29,309,280,2025-07-23 23:42:36.529861
289,1393,2023-04-08,112,67,454,387,2025-07-23 23:42:36.530987
290,1050,2023-06-21,154,61,232,171,2025-07-23 23:42:36.532128
291,854,2024-01-26,11,154,381,227,2025-07-23 23:42:36.533262
292,530,2024-02-08,239,60,188,128,2025-07-23 23:42:36.534377
293,424,2023-03-06,11,276,290,14,2025-07-23 23:42:36.535447
294,817,2023-03-28,133,132,291,159,2025-07-23 23:42:36.536485
295,275,2024-01-17,229,407,453,46,2025-07-23 23:42:36.537450
296,346,2022-09-11,128,6,46,40,2025-07-23 23:42:36.538477
297,449,2023-03-27,194,4,155,151,2025-07-23 23:42:36.539562
298,544,2022-08-29,170,34,269,235,2025-07-23 23:42:36.540626
299,349,2022-11-17,45,76,189,113,2025-07-23 23:42:36.541700
300,176,2024-12-12,35,222,306,84,2025-07-23 23:42:36.542784
301,1170,2023-05-06,139,121,138,17,2025-07-23 23:42:36.543832
302,1265,2022-07-12,219,285,338,53,2025-07-23 23:42:36.544917
303,87,2022-03-24,2,133,327,194,2025-07-23 23:42:36.545984
304,666,2022-09-24,218,159,198,39,2025-07-23 23:42:36.547122
305,219,2023-09-08,5,165,267,102,2025-07-23 23:42:36.548184
306,540,2023-09-07,79,19,261,242,2025-07-23 23:42:36.549296
307,675,2022-10-18,107,1,18,17,2025-07-23 23:42:36.550342
308,1484,2024-07-18,91,167,477,310,2025-07-23 23:42:36.551434
309,579,2024-01-23,208,272,476,204,2025-07-23 23:42:36.552527
310,617,2023-01-01,52,37,141,104,2025-07-23 23:42:36.553601
311,1263,2023-12-08,188,212,366,154,2025-07-23 23:42:36.554672
312,1115,2023-06-19,95,76,106,30,2025-07-23 23:42:36.555737
313,688,2023-05-21,61,61,114,53,2025-07-23 23:42:36.556828
314,940,2023-01-05,29,105,273,168,2025-07-23 23:42:36.562081
315,235,2024-11-29,13,22,44,22,2025-07-23 23:42:36.563247
316,310,2023-02-05,165,4,217,213,2025-07-23 23:42:36.564319
317,568,2023-05-17,198,237,474,237,2025-07-23 23:42:36.565379
318,1355,2022-09-16,186,59,64,5,2025-07-23 23:42:36.566453
319,570,2023-01-20,113,39,495,456,2025-07-23 23:42:36.567582
320,671,2024-08-09,94,313,345,32,2025-07-23 23:42:36.568677
321,188,2022-11-03,79,53,99,46,2025-07-23 23:42:36.569733
322,665,2023-04-14,155,20,148,128,2025-07-23 23:42:36.570870
323,1225,2022-05-06,4,238,302,64,2025-07-23 23:42:36.571945
324,454,2024-04-22,31,185,474,289,2025-07-23 23:42:36.573018
325,934,2022-09-06,94,204,350,146,2025-07-23 23:42:36.574113
326,501,2024-10-18,65,221,462,241,2025-07-23 23:42:36.575187
327,1121,2023-05-19,221,182,409,227,2025-07-23 23:42:36.576279
328,714,2022-11-25,105,78,365,287,2025-07-23 23:42:36.577356
329,954,2024-05-12,154,26,139,113,2025-07-23 23:42:36.578415
330,413,2023-06-09,47,4,240,236,2025-07-23 23:42:36.579485
331,77,2024-05-24,56,254,400,146,2025-07-23 23:42:36.580549
332,631,2022-05-28,120,216,418,202,2025-07-23 23:42:36.581618
333,1250,2022-10-22,171,328,455,127,2025-07-23 23:42:36.582678
334,490,2022-06-01,46,15,189,174,2025-07-23 23:42:36.583951
335,1367,2023-09-03,201,206,216,10,2025-07-23 23:42:36.585094
336,1102,2024-08-20,71,60,241,181,2025-07-23 23:42:36.586206
337,834,2024-01-15,176,9,116,107,2025-07-23 23:42:36.587274
338,1393,2022-09-21,213,100,339,239,2025-07-23 23:42:36.588543
339,1467,2023-10-02,237,121,277,156,2025-07-23 23:42:36.589653
340,1170,2024-01-04,196,72,89,17,2025-07-23 23:42:36.590706
341,796,2024-11-28,247,21,29,8,2025-07-23 23:42:36.591808
342,425,2024-01-21,84,12,321,309,2025-07-23 23:42:36.592857
343,1187,2023-11-23,122,303,347,44,2025-07-23 23:42:36.594017
344,546,2022-03-01,100,2,490,488,2025-07-23 23:42:36.595113
345,259,2024-07-24,8,195,443,248,2025-07-23 23:42:36.596156
346,475,2022-05-06,171,125,165,40,2025-07-23 23:42:36.597229
347,930,2022-10-27,118,292,372,80,2025-07-23 23:42:36.598298
348,204,2024-04-04,158,28,73,45,2025-07-23 23:42:36.599354
349,1438,2024-05-11,102,12,137,125,2025-07-23 23:42:36.600413
350,1482,2023-08-06,230,115,268,153,2025-07-23 23:42:36.601484
351,1335,2024-10-10,44,3,59,56,2025-07-23 23:42:36.602631
352,1265,2024-12-22,182,40,82,42,2025-07-23 23:42:36.603694
353,963,2024-06-10,233,213,221,8,2025-07-23 23:42:36.604801
354,1313,2023-04-14,170,50,166,116,2025-07-23 23:42:36.605857
355,1093,2024-12-09,119,114,213,99,2025-07-23 23:42:36.606904
356,870,2024-03-23,180,7,41,34,2025-07-23 23:42:36.607980
357,1467,2023-01-31,153,174,262,88,2025-07-23 23:42:36.609099
358,101,2024-08-31,132,28,207,179,2025-07-23 23:42:36.610157
359,170,2023-11-24,10,194,211,17,2025-07-23 23:42:36.611222
360,668,2024-09-03,126,42,61,19,2025-07-23 23:42:36.612287
361,1428,2022-12-25,105,179,343,164,2025-07-23 23:42:36.613412
362,1069,2023-02-10,198,212,359,147,2025-07-23 23:42:36.614486
363,933,2024-12-31,230,173,269,96,2025-07-23 23:42:36.615543
364,1347,2023-04-10,28,27,41,14,2025-07-23 23:42:36.616604
365,1025,2022-02-09,191,18,143,125,2025-07-23 23:42:36.617666
366,21,2024-07-10,72,13,121,108,2025-07-23 23:42:36.618723
367,45,2022-03-01,123,185,418,233,2025-07-23 23:42:36.619831
368,54,2023-11-12,127,189,294,105,2025-07-23 23:42:36.620886
369,1086,2022-03-12,166,178,360,182,2025-07-23 23:42:36.621941
370,654,2024-04-17,182,21,44,23,2025-07-23 23:42:36.623041
371,808,2024-06-14,103,261,281,20,2025-07-23 23:42:36.624183
372,1464,2024-07-10,209,0,13,13,2025-07-23 23:42:36.625262
373,30,2024-03-08,178,228,427,199,2025-07-23 23:42:36.626370
374,937,2024-12-06,152,220,370,150,2025-07-23 23:42:36.627440
375,1206,2023-04-25,126,73,304,231,2025-07-23 23:42:36.628497
376,992,2024-05-31,154,188,240,52,2025-07-23 23:42:36.629598
377,629,2023-03-10,39,92,156,64,2025-07-23 23:42:36.630671
378,1071,2022-08-16,234,85,137,52,2025-07-23 23:42:36.631812
379,534,2024-02-02,17,45,172,127,2025-07-23 23:42:36.632864
380,869,2023-01-10,81,122,376,254,2025-07-23 23:42:36.633940
381,611,2024-03-23,216,4,411,407,2025-07-23 23:42:36.635022
382,421,2022-01-17,39,112,397,285,2025-07-23 23:42:36.636128
383,394,2023-05-12,227,32,48,16,2025-07-23 23:42:36.637201
384,110,2022-02-10,129,39,220,181,2025-07-23 23:42:36.638289
385,962,2022-11-28,83,59,152,93,2025-07-23 23:42:36.639373
386,777,2024-04-05,88,157,226,69,2025-07-23 23:42:36.640447
387,504,2024-09-02,192,257,383,126,2025-07-23 23:42:36.641516
388,362,2024-04-12,188,89,140,51,2025-07-23 23:42:36.642590
389,647,2023-06-27,163,100,470,370,2025-07-23 23:42:36.643651
390,1360,2023-01-05,248,25,273,248,2025-07-23 23:42:36.644718
391,598,2022-02-24,44,91,448,357,2025-07-23 23:42:36.645850
392,1419,2022-01-13,48,26,124,98,2025-07-23 23:42:36.646921
393,872,2024-03-17,71,329,375,46,2025-07-23 23:42:36.647982
394,889,2022-02-16,107,100,179,79,2025-07-23 23:42:36.649057
395,1363,2023-02-25,182,385,425,40,2025-07-23 23:42:36.650124
396,357,2022-02-24,199,95,458,363,2025-07-23 23:42:36.651205
397,1143,2022-08-18,199,65,336,271,2025-07-23 23:42:36.652242
398,724,2023-12-03,166,244,269,25,2025-07-23 23:42:36.653331
399,146,2024-11-16,122,288,450,162,2025-07-23 23:42:36.654448
400,899,2023-02-18,137,224,334,110,2025-07-23 23:42:36.655522
401,1453,2022-12-28,217,4,62,58,2025-07-23 23:42:36.656575
402,294,2022-08-26,216,124,182,58,2025-07-23 23:42:36.657644
403,484,2023-08-11,211,19,24,5,2025-07-23 23:42:36.658722
404,466,2022-09-18,164,24,388,364,2025-07-23 23:42:36.659880
405,1278,2022-02-09,97,287,386,99,2025-07-23 23:42:36.661048
406,442,2022-07-20,126,234,310,76,2025-07-23 23:42:36.662198
407,942,2022-07-05,212,40,163,123,2025-07-23 23:42:36.663399
408,967,2023-03-25,169,117,197,80,2025-07-23 23:42:36.664569
409,847,2023-01-19,222,116,493,377,2025-07-23 23:42:36.665682
410,677,2022-06-17,237,131,263,132,2025-07-23 23:42:36.666849
411,1019,2023-02-20,169,274,365,91,2025-07-23 23:42:36.667974
412,338,2023-07-05,161,83,278,195,2025-07-23 23:42:36.669135
413,307,2024-02-14,159,26,85,59,2025-07-23 23:42:36.670244
414,665,2022-08-16,160,330,378,48,2025-07-23 23:42:36.671364
415,741,2023-08-05,160,4,11,7,2025-07-23 23:42:36.672440
416,902,2023-07-09,22,2,18,16,2025-07-23 23:42:36.673592
417,339,2024-07-28,62,145,246,101,2025-07-23 23:42:36.674711
418,440,2023-12-06,117,189,389,200,2025-07-23 23:42:36.675906
419,1048,2023-05-06,65,0,138,138,2025-07-23 23:42:36.677074
420,1041,2023-04-22,170,70,82,12,2025-07-23 23:42:36.678198
421,35,2023-11-22,143,53,314,261,2025-07-23 23:42:36.679378
422,660,2022-02-27,113,150,392,242,2025-07-23 23:42:36.680519
423,170,2024-02-22,107,48,223,175,2025-07-23 23:42:36.681629
424,413,2022-11-04,14,26,36,10,2025-07-23 23:42:36.682747
425,806,2023-11-02,112,23,32,9,2025-07-23 23:42:36.684457
426,1484,2023-02-04,30,88,101,13,2025-07-23 23:42:36.685670
427,1321,2024-11-19,164,10,30,20,2025-07-23 23:42:36.686788
428,688,2022-11-14,141,8,139,131,2025-07-23 23:42:36.687829
429,623,2024-10-10,3,74,152,78,2025-07-23 23:42:36.688868
430,115,2023-02-22,111,10,27,17,2025-07-23 23:42:36.689934
431,346,2023-02-02,22,362,444,82,2025-07-23 23:42:36.691005
432,826,2024-03-19,2,137,448,311,2025-07-23 23:42:36.692061
433,249,2023-11-18,237,438,466,28,2025-07-23 23:42:36.693129
434,812,2023-11-24,192,256,396,140,2025-07-23 23:42:36.694226
435,91,2022-06-28,16,4,12,8,2025-07-23 23:42:36.695364
436,1254,2023-03-08,139,280,500,220,2025-07-23 23:42:36.696496
437,666,2022-01-05,67,19,355,336,2025-07-23 23:42:36.697367
438,376,2022-03-28,21,88,131,43,2025-07-23 23:42:36.698116
439,1328,2022-12-08,79,453,489,36,2025-07-23 23:42:36.698798
440,1333,2023-07-22,96,74,280,206,2025-07-23 23:42:36.699469
441,1271,2023-07-12,58,242,461,219,2025-07-23 23:42:36.700313
442,463,2023-10-12,21,61,270,209,2025-07-23 23:42:36.701021
443,850,2024-10-11,200,13,192,179,2025-07-23 23:42:36.701636
444,455,2023-10-30,199,212,249,37,2025-07-23 23:42:36.702330
445,147,2022-07-07,171,15,81,66,2025-07-23 23:42:36.703011
446,903,2022-06-24,231,408,492,84,2025-07-23 23:42:36.703621
447,24,2022-08-07,46,225,380,155,2025-07-23 23:42:36.704314
448,1179,2022-04-22,190,382,481,99,2025-07-23 23:42:36.704971
449,53,2023-07-22,181,172,419,247,2025-07-23 23:42:36.705599
450,1138,2024-07-04,132,183,274,91,2025-07-23 23:42:36.706251
451,1264,2022-08-13,138,86,164,78,2025-07-23 23:42:36.706872
452,1170,2023-05-18,92,5,21,16,2025-07-23 23:42:36.707487
453,569,2022-03-04,211,188,494,306,2025-07-23 23:42:36.708123
454,1225,2024-10-19,96,254,261,7,2025-07-23 23:42:36.709022
455,775,2024-03-28,163,279,332,53,2025-07-23 23:42:36.709691
456,131,2023-02-01,132,3,195,192,2025-07-23 23:42:36.710433
457,748,2023-11-12,126,117,181,64,2025-07-23 23:42:36.711098
458,852,2023-01-26,158,178,466,288,2025-07-23 23:42:36.711738
459,834,2024-03-01,44,8,379,371,2025-07-23 23:42:36.712408
460,1455,2022-01-16,154,240,313,73,2025-07-23 23:42:36.713059
461,564,2023-10-30,131,273,473,200,2025-07-23 23:42:36.713679
462,417,2022-10-16,161,147,486,339,2025-07-23 23:42:36.714326
463,569,2023-09-14,148,87,395,308,2025-07-23 23:42:36.714962
464,996,2024-04-25,11,90,330,240,2025-07-23 23:42:36.715616
465,1040,2023-07-28,118,38,90,52,2025-07-23 23:42:36.716265
466,387,2024-06-05,104,218,455,237,2025-07-23 23:42:36.716904
467,903,2023-11-15,102,5,136,131,2025-07-23 23:42:36.717516
468,758,2024-02-18,140,158,482,324,2025-07-23 23:42:36.718175
469,375,2022-06-21,224,88,126,38,2025-07-23 23:42:36.718796
470,409,2024-07-11,113,58,239,181,2025-07-23 23:42:36.719411
471,1420,2022-08-19,151,384,450,66,2025-07-23 23:42:36.720042
472,915,2024-11-25,153,225,281,56,2025-07-23 23:42:36.720650
473,35,2023-06-03,18,68,109,41,2025-07-23 23:42:36.721305
474,74,2023-09-14,70,206,454,248,2025-07-23 23:42:36.722081
475,554,2022-08-26,131,42,88,46,2025-07-23 23:42:36.722962
476,1482,2022-02-21,199,26,35,9,2025-07-23 23:42:36.723892
477,892,2022-06-04,60,31,113,82,2025-07-23 23:42:36.724895
478,1004,2022-06-30,180,276,322,46,2025-07-23 23:42:36.725864
479,1009,2022-07-27,82,171,187,16,2025-07-23 23:42:36.726990
480,412,2023-11-25,138,104,437,333,2025-07-23 23:42:36.728003
481,1450,2023-10-08,145,160,375,215,2025-07-23 23:42:36.729016
482,43,2024-07-29,15,14,21,7,2025-07-23 23:42:36.730007
483,346,2022-03-27,239,49,225,176,2025-07-23 23:42:36.731126
484,1309,2024-09-16,160,69,312,243,2025-07-23 23:42:36.732205
485,828,2022-08-23,221,158,424,266,2025-07-23 23:42:36.733212
486,795,2022-09-23,163,48,464,416,2025-07-23 23:42:36.734204
487,1488,2024-05-10,39,174,376,202,2025-07-23 23:42:36.735178
488,173,2022-04-23,97,79,113,34,2025-07-23 23:42:36.736177
489,788,2022-11-11,9,19,103,84,2025-07-23 23:42:36.737180
490,921,2023-08-23,5,251,329,78,2025-07-23 23:42:36.738179
491,650,2023-04-08,93,26,51,25,2025-07-23 23:42:36.739140
492,747,2023-11-10,150,285,305,20,2025-07-23 23:42:36.740124
493,1,2023-08-16,214,67,337,270,2025-07-23 23:42:36.741130
494,271,2023-10-17,113,361,471,110,2025-07-23 23:42:36.742098
495,656,2024-09-16,148,30,66,36,2025-07-23 23:42:36.743074
496,819,2023-10-27,38,13,46,33,2025-07-23 23:42:36.744040
497,1325,2022-07-10,161,82,412,330,2025-07-23 23:42:36.745007
498,870,2024-12-15,137,47,134,87,2025-07-23 23:42:36.745968
499,966,2023-08-10,115,66,167,101,2025-07-23 23:42:36.746897
500,1059,2023-01-22,178,69,93,24,2025-07-23 23:42:36.747874
501,741,2023-09-05,13,14,20,6,2025-07-23 23:42:36.748873
502,67,2023-11-27,133,23,159,136,2025-07-23 23:42:36.749861
503,304,2022-11-19,15,222,263,41,2025-07-23 23:42:36.750874
504,21,2022-02-08,108,105,182,77,2025-07-23 23:42:36.751858
505,1100,2023-07-24,209,26,48,22,2025-07-23 23:42:36.752805
506,923,2024-04-24,11,411,456,45,2025-07-23 23:42:36.753799
507,602,2024-10-28,86,125,488,363,2025-07-23 23:42:36.754745
508,1053,2023-11-28,242,14,320,306,2025-07-23 23:42:36.755705
509,458,2023-12-29,46,128,184,56,2025-07-23 23:42:36.756699
510,1378,2024-07-07,138,193,250,57,2025-07-23 23:42:36.757991
511,1432,2023-07-17,35,247,381,134,2025-07-23 23:42:36.759031
512,44,2024-06-21,33,108,124,16,2025-07-23 23:42:36.759975
513,240,2023-09-14,214,28,208,180,2025-07-23 23:42:36.761050
514,792,2023-12-01,215,47,56,9,2025-07-23 23:42:36.762019
515,168,2022-10-26,110,95,115,20,2025-07-23 23:42:36.763155
516,1235,2024-01-27,138,27,182,155,2025-07-23 23:42:36.764406
517,1500,2024-03-09,243,16,27,11,2025-07-23 23:42:36.765462
518,1359,2023-06-22,145,233,299,66,2025-07-23 23:42:36.766465
519,76,2022-03-13,150,133,179,46,2025-07-23 23:42:36.767454
520,158,2022-10-28,14,163,211,48,2025-07-23 23:42:36.768464
521,247,2024-07-20,70,320,450,130,2025-07-23 23:42:36.769459
522,324,2024-01-02,124,121,130,9,2025-07-23 23:42:36.770605
523,1184,2023-04-06,223,128,184,56,2025-07-23 23:42:36.771959
524,212,2022-11-09,224,230,270,40,2025-07-23 23:42:36.773049
525,38,2022-05-28,46,43,84,41,2025-07-23 23:42:36.774154
526,888,2024-03-15,210,275,387,112,2025-07-23 23:42:36.775192
527,713,2024-12-22,141,43,467,424,2025-07-23 23:42:36.776202
528,1093,2024-01-31,135,15,85,70,2025-07-23 23:42:36.777264
529,1315,2024-08-21,218,17,54,37,2025-07-23 23:42:36.778300
530,1118,2023-09-12,125,128,291,163,2025-07-23 23:42:36.779674
531,998,2022-06-03,105,325,361,36,2025-07-23 23:42:36.780739
532,129,2023-08-15,242,141,147,6,2025-07-23 23:42:36.781971
533,398,2024-01-02,9,340,347,7,2025-07-23 23:42:36.782966
534,782,2024-11-10,103,0,234,234,2025-07-23 23:42:36.783959
535,706,2024-08-28,145,214,359,145,2025-07-23 23:42:36.784905
536,291,2024-05-03,107,34,269,235,2025-07-23 23:42:36.786162
537,367,2022-06-16,92,138,161,23,2025-07-23 23:42:36.787125
538,1233,2022-01-19,240,9,49,40,2025-07-23 23:42:36.788128
539,530,2023-02-27,154,304,423,119,2025-07-23 23:42:36.789152
540,1363,2022-08-22,113,100,208,108,2025-07-23 23:42:36.790167
541,399,2023-09-27,170,193,225,32,2025-07-23 23:42:36.791160
542,1414,2024-10-26,206,4,326,322,2025-07-23 23:42:36.792151
543,1255,2024-06-09,93,0,56,56,2025-07-23 23:42:36.793157
544,1423,2023-03-23,149,52,78,26,2025-07-23 23:42:36.794143
545,283,2023-03-05,158,390,417,27,2025-07-23 23:42:36.795118
546,1429,2022-04-05,60,122,163,41,2025-07-23 23:42:36.796061
547,148,2022-08-31,204,40,390,350,2025-07-23 23:42:36.797153
548,1369,2023-10-25,19,9,33,24,2025-07-23 23:42:36.798205
549,1453,2023-05-30,110,295,414,119,2025-07-23 23:42:36.799354
550,852,2024-05-04,181,329,394,65,2025-07-23 23:42:36.800443
551,1326,2022-11-02,10,93,172,79,2025-07-23 23:42:36.801492
552,57,2022-12-03,17,149,220,71,2025-07-23 23:42:36.802455
553,275,2024-06-15,4,263,425,162,2025-07-23 23:42:36.803436
554,1189,2024-01-11,164,129,257,128,2025-07-23 23:42:36.804427
555,648,2024-04-02,145,46,422,376,2025-07-23 23:42:36.805390
556,1252,2024-03-19,193,195,284,89,2025-07-23 23:42:36.806353
557,1062,2022-06-27,180,402,456,54,2025-07-23 23:42:36.807280
558,990,2024-07-03,70,69,86,17,2025-07-23 23:42:36.808196
559,332,2023-04-23,243,66,279,213,2025-07-23 23:42:36.809176
560,879,2023-11-20,62,33,136,103,2025-07-23 23:42:36.810149
561,1270,2023-08-31,6,294,367,73,2025-07-23 23:42:36.811121
562,444,2024-04-26,187,13,39,26,2025-07-23 23:42:36.812097
563,723,2023-07-02,228,61,220,159,2025-07-23 23:42:36.813079
564,983,2024-09-17,148,319,345,26,2025-07-23 23:42:36.814025
565,818,2023-11-11,144,362,369,7,2025-07-23 23:42:36.815039
566,1060,2022-07-01,240,179,223,44,2025-07-23 23:42:36.816021
567,7,2023-02-27,31,96,344,248,2025-07-23 23:42:36.817016
568,15,2023-07-25,8,119,271,152,2025-07-23 23:42:36.817953
569,1191,2024-01-04,86,7,29,22,2025-07-23 23:42:36.818879
570,173,2023-04-22,184,94,187,93,2025-07-23 23:42:36.819860
571,1093,2024-01-22,178,72,158,86,2025-07-23 23:42:36.820873
572,1460,2024-02-26,216,17,430,413,2025-07-23 23:42:36.821874
573,1199,2023-12-15,64,224,386,162,2025-07-23 23:42:36.822863
574,1202,2022-07-09,177,81,340,259,2025-07-23 23:42:36.823871
575,826,2023-03-12,24,13,49,36,2025-07-23 23:42:36.824864
576,916,2022-01-26,105,6,95,89,2025-07-23 23:42:36.825831
577,1369,2023-07-12,104,161,317,156,2025-07-23 23:42:36.826743
578,629,2023-12-17,167,7,40,33,2025-07-23 23:42:36.827670
579,357,2022-09-25,193,129,400,271,2025-07-23 23:42:36.828593
580,241,2022-05-14,76,150,368,218,2025-07-23 23:42:36.829570
581,304,2024-12-13,178,38,206,168,2025-07-23 23:42:36.830530
582,863,2024-05-02,165,326,340,14,2025-07-23 23:42:36.831490
583,70,2022-11-15,138,328,423,95,2025-07-23 23:42:36.832456
584,548,2022-07-21,97,294,416,122,2025-07-23 23:42:36.833423
585,279,2022-10-18,248,199,216,17,2025-07-23 23:42:36.834388
586,950,2022-04-18,148,76,85,9,2025-07-23 23:42:36.835357
587,637,2024-06-02,134,39,103,64,2025-07-23 23:42:36.836323
588,1447,2022-10-25,147,84,90,6,2025-07-23 23:42:36.837427
589,122,2022-08-26,219,26,148,122,2025-07-23 23:42:36.838549
590,265,2022-12-24,111,167,337,170,2025-07-23 23:42:36.839616
591,45,2022-07-16,67,458,494,36,2025-07-23 23:42:36.840624
592,717,2024-07-17,69,191,261,70,2025-07-23 23:42:36.841617
593,289,2023-07-25,139,57,116,59,2025-07-23 23:42:36.842607
594,1414,2024-04-27,96,14,39,25,2025-07-23 23:42:36.843590
595,459,2024-12-04,171,72,78,6,2025-07-23 23:42:36.844561
596,121,2024-01-09,140,1,20,19,2025-07-23 23:42:36.845526
597,1059,2024-05-14,48,107,265,158,2025-07-23 23:42:36.846480
598,865,2022-02-15,221,303,429,126,2025-07-23 23:42:36.847471
599,791,2024-06-25,15,23,252,229,2025-07-23 23:42:36.848426
600,59,2023-09-26,163,14,22,8,2025-07-23 23:42:36.849459
601,1096,2023-04-08,34,64,184,120,2025-07-23 23:42:36.850465
602,246,2023-11-08,195,132,315,183,2025-07-23 23:42:36.851589
603,549,2022-04-22,106,42,145,103,2025-07-23 23:42:36.852573
604,663,2022-10-15,193,204,424,220,2025-07-23 23:42:36.853549
605,785,2022-09-11,234,32,39,7,2025-07-23 23:42:36.854517
606,778,2024-08-18,17,146,247,101,2025-07-23 23:42:36.855484
607,237,2022-12-05,68,430,483,53,2025-07-23 23:42:36.856460
608,789,2022-07-20,158,15,44,29,2025-07-23 23:42:36.857442
609,599,2023-05-24,217,102,194,92,2025-07-23 23:42:36.858408
610,175,2024-09-09,221,235,317,82,2025-07-23 23:42:36.859368
611,497,2023-10-10,27,449,500,51,2025-07-23 23:42:36.860320
612,961,2023-07-08,76,92,367,275,2025-07-23 23:42:36.861282
613,1065,2024-09-19,237,247,396,149,2025-07-23 23:42:36.862230
614,1437,2022-05-21,155,150,298,148,2025-07-23 23:42:36.863182
615,925,2023-08-08,206,10,85,75,2025-07-23 23:42:36.864143
616,378,2022-05-16,102,20,277,257,2025-07-23 23:42:36.865113
617,1445,2022-04-29,236,86,166,80,2025-07-23 23:42:36.866068
618,548,2022-02-10,121,221,485,264,2025-07-23 23:42:36.867013
619,18,2024-04-29,77,180,391,211,2025-07-23 23:42:36.867961
620,822,2023-05-12,72,130,216,86,2025-07-23 23:42:36.868934
621,754,2024-07-02,65,2,258,256,2025-07-23 23:42:36.869871
622,863,2022-12-08,207,15,22,7,2025-07-23 23:42:36.870854
623,171,2023-08-11,230,471,481,10,2025-07-23 23:42:36.871819
624,675,2023-03-26,45,18,113,95,2025-07-23 23:42:36.872750
625,921,2023-08-29,194,395,418,23,2025-07-23 23:42:36.873711
626,591,2022-06-02,208,21,495,474,2025-07-23 23:42:36.874665
627,1291,2022-03-07,148,136,182,46,2025-07-23 23:42:36.875628
628,33,2022-04-12,38,211,301,90,2025-07-23 23:42:36.876585
629,846,2023-03-28,182,44,143,99,2025-07-23 23:42:36.877529
630,1015,2024-09-28,136,71,245,174,2025-07-23 23:42:36.878493
631,664,2022-05-17,73,159,182,23,2025-07-23 23:42:36.879494
632,1368,2023-09-22,66,304,446,142,2025-07-23 23:42:36.880482
633,824,2024-10-12,216,285,302,17,2025-07-23 23:42:36.881467
634,940,2022-05-31,68,35,111,76,2025-07-23 23:42:36.882468
635,744,2024-01-07,44,47,91,44,2025-07-23 23:42:36.883437
636,1041,2024-09-09,56,311,362,51,2025-07-23 23:42:36.884422
637,1256,2023-02-27,66,393,403,10,2025-07-23 23:42:36.885419
638,48,2023-12-16,90,85,101,16,2025-07-23 23:42:36.886391
639,204,2022-07-13,213,249,340,91,2025-07-23 23:42:36.887656
640,453,2022-03-04,223,282,334,52,2025-07-23 23:42:36.888656
641,1044,2023-03-30,189,116,388,272,2025-07-23 23:42:36.889714
642,1456,2024-03-07,201,23,264,241,2025-07-23 23:42:36.890653
643,1270,2024-08-24,21,1,412,411,2025-07-23 23:42:36.891605
644,457,2022-11-18,129,171,223,52,2025-07-23 23:42:36.892551
645,11,2024-03-10,194,83,205,122,2025-07-23 23:42:36.893490
646,466,2023-04-01,180,80,328,248,2025-07-23 23:42:36.894437
647,810,2024-05-13,62,17,31,14,2025-07-23 23:42:36.895403
648,64,2024-07-16,49,184,491,307,2025-07-23 23:42:36.896347
649,1079,2023-12-13,88,453,463,10,2025-07-23 23:42:36.897411
650,963,2023-07-27,142,417,452,35,2025-07-23 23:42:36.898590
651,866,2024-03-07,144,22,153,131,2025-07-23 23:42:36.899541
652,726,2023-11-19,139,80,408,328,2025-07-23 23:42:36.900476
653,279,2024-06-07,222,105,330,225,2025-07-23 23:42:36.901436
654,545,2022-11-24,43,145,174,29,2025-07-23 23:42:36.902379
655,1276,2024-03-29,25,105,144,39,2025-07-23 23:42:36.903629
656,49,2022-03-14,244,149,164,15,2025-07-23 23:42:36.904683
657,1139,2022-11-09,14,70,149,79,2025-07-23 23:42:36.905722
658,1368,2022-08-30,147,343,461,118,2025-07-23 23:42:36.907088
659,988,2024-02-07,105,219,310,91,2025-07-23 23:42:36.908158
660,1369,2024-02-02,152,70,349,279,2025-07-23 23:42:36.909144
661,20,2022-09-14,112,262,284,22,2025-07-23 23:42:36.910202
662,1479,2024-08-21,239,178,275,97,2025-07-23 23:42:36.911557
663,1197,2024-01-13,34,155,257,102,2025-07-23 23:42:36.912539
664,1028,2024-06-24,31,43,78,35,2025-07-23 23:42:36.913649
665,351,2024-07-17,2,35,155,120,2025-07-23 23:42:36.914902
666,1130,2024-07-12,244,106,124,18,2025-07-23 23:42:36.916027
667,234,2023-09-23,178,303,448,145,2025-07-23 23:42:36.917089
668,148,2022-06-04,124,45,109,64,2025-07-23 23:42:36.918054
669,60,2024-02-10,25,142,198,56,2025-07-23 23:42:36.919064
670,1469,2024-01-13,131,6,225,219,2025-07-23 23:42:36.920169
671,549,2023-11-15,219,94,343,249,2025-07-23 23:42:36.921268
672,839,2023-01-10,193,66,214,148,2025-07-23 23:42:36.922287
673,1289,2022-11-28,73,2,31,29,2025-07-23 23:42:36.923398
674,817,2023-03-23,75,145,331,186,2025-07-23 23:42:36.924383
675,1140,2023-02-24,34,247,449,202,2025-07-23 23:42:36.925908
676,866,2023-05-19,189,164,395,231,2025-07-23 23:42:36.927141
677,1118,2024-01-09,154,210,394,184,2025-07-23 23:42:36.928239
678,657,2024-06-21,64,116,137,21,2025-07-23 23:42:36.929331
679,207,2023-06-07,205,10,37,27,2025-07-23 23:42:36.930520
680,331,2024-01-05,83,15,46,31,2025-07-23 23:42:36.931502
681,768,2023-01-29,104,73,215,142,2025-07-23 23:42:36.932580
682,1024,2022-02-10,83,62,381,319,2025-07-23 23:42:36.933832
683,461,2024-04-02,232,3,141,138,2025-07-23 23:42:36.934898
684,319,2024-03-29,165,89,188,99,2025-07-23 23:42:36.935944
685,1106,2022-11-12,47,153,220,67,2025-07-23 23:42:36.937297
686,933,2023-07-24,36,162,435,273,2025-07-23 23:42:36.938349
687,825,2022-05-15,149,123,394,271,2025-07-23 23:42:36.939317
688,1409,2022-09-21,216,189,276,87,2025-07-23 23:42:36.940312
689,786,2022-04-19,74,120,440,320,2025-07-23 23:42:36.941259
690,357,2024-02-15,240,4,34,30,2025-07-23 23:42:36.942226
691,629,2024-07-23,34,75,204,129,2025-07-23 23:42:36.943202
692,143,2024-07-18,97,249,351,102,2025-07-23 23:42:36.944180
693,1243,2024-04-19,11,107,386,279,2025-07-23 23:42:36.945185
694,729,2023-09-18,39,69,157,88,2025-07-23 23:42:36.946171
695,970,2023-10-11,36,26,34,8,2025-07-23 23:42:36.947125
696,277,2024-03-27,129,143,385,242,2025-07-23 23:42:36.948096
697,424,2023-08-13,228,129,203,74,2025-07-23 23:42:36.949071
698,470,2024-06-05,181,269,436,167,2025-07-23 23:42:36.951238
699,129,2022-10-10,207,134,353,219,2025-07-23 23:42:36.952332
700,260,2024-04-08,223,24,200,176,2025-07-23 23:42:36.953373
701,1247,2023-05-11,128,39,63,24,2025-07-23 23:42:36.954510
702,448,2023-11-17,202,21,92,71,2025-07-23 23:42:36.955614
703,1490,2022-05-01,49,5,58,53,2025-07-23 23:42:36.956665
704,1041,2024-03-06,245,100,180,80,2025-07-23 23:42:36.957706
705,297,2023-09-03,189,3,136,133,2025-07-23 23:42:36.958730
706,994,2024-10-24,35,74,216,142,2025-07-23 23:42:36.963109
707,723,2023-10-13,145,31,311,280,2025-07-23 23:42:36.964198
708,204,2024-11-30,200,14,202,188,2025-07-23 23:42:36.965391
709,985,2024-12-24,131,15,31,16,2025-07-23 23:42:36.966435
710,1141,2023-07-05,186,27,144,117,2025-07-23 23:42:36.967669
711,208,2023-01-07,107,134,236,102,2025-07-23 23:42:36.968837
712,810,2022-03-30,115,315,365,50,2025-07-23 23:42:36.969960
713,523,2022-06-15,192,122,198,76,2025-07-23 23:42:36.971042
714,487,2022-09-22,83,156,238,82,2025-07-23 23:42:36.972122
715,116,2023-12-02,50,177,320,143,2025-07-23 23:42:36.973211
716,348,2024-08-27,153,72,189,117,2025-07-23 23:42:36.974280
717,879,2024-05-08,108,51,127,76,2025-07-23 23:42:36.975352
718,211,2023-12-16,9,107,204,97,2025-07-23 23:42:36.976419
719,196,2024-09-26,121,67,132,65,2025-07-23 23:42:36.977533
720,1212,2024-09-05,130,282,310,28,2025-07-23 23:42:36.978651
721,1479,2023-10-19,105,221,230,9,2025-07-23 23:42:36.979791
722,893,2022-01-12,104,6,15,9,2025-07-23 23:42:36.980914
723,302,2024-04-27,73,273,375,102,2025-07-23 23:42:36.982044
724,1022,2024-11-28,87,97,273,176,2025-07-23 23:42:36.983203
725,393,2022-10-04,99,29,136,107,2025-07-23 23:42:36.984377
726,403,2022-06-03,62,311,367,56,2025-07-23 23:42:36.985831
727,1214,2023-05-26,51,13,144,131,2025-07-23 23:42:36.987071
728,1147,2022-08-21,202,1,81,80,2025-07-23 23:42:36.988215
729,882,2022-07-27,128,16,143,127,2025-07-23 23:42:36.989322
730,743,2022-01-18,111,210,412,202,2025-07-23 23:42:36.990392
731,380,2024-05-19,173,318,483,165,2025-07-23 23:42:36.991385
732,1307,2024-05-16,99,145,319,174,2025-07-23 23:42:36.992121
733,625,2023-02-02,127,71,108,37,2025-07-23 23:42:36.992735
734,1067,2023-01-27,154,317,346,29,2025-07-23 23:42:36.993439
735,768,2022-05-25,237,152,388,236,2025-07-23 23:42:36.994129
736,1478,2022-02-14,12,10,87,77,2025-07-23 23:42:36.994740
737,48,2023-01-02,188,198,360,162,2025-07-23 23:42:36.995414
738,1061,2023-07-14,204,40,446,406,2025-07-23 23:42:36.996093
739,852,2023-12-03,2,81,131,50,2025-07-23 23:42:36.996691
740,475,2022-09-09,72,116,133,17,2025-07-23 23:42:36.997327
741,764,2024-05-17,36,0,36,36,2025-07-23 23:42:36.997954
742,1100,2023-06-24,46,54,241,187,2025-07-23 23:42:36.998548
743,806,2023-08-26,66,169,450,281,2025-07-23 23:42:36.999174
744,17,2022-12-28,44,15,404,389,2025-07-23 23:42:36.999776
745,1497,2022-07-19,25,181,456,275,2025-07-23 23:42:37.000420
746,363,2022-05-30,144,121,285,164,2025-07-23 23:42:37.001052
747,509,2023-10-12,33,337,348,11,2025-07-23 23:42:37.001643
748,367,2023-03-08,56,73,438,365,2025-07-23 23:42:37.002272
749,984,2022-05-11,247,2,194,192,2025-07-23 23:42:37.002973
750,811,2023-04-27,89,71,127,56,2025-07-23 23:42:37.004077
751,897,2023-01-02,55,14,107,93,2025-07-23 23:42:37.005111
752,1192,2024-04-22,190,6,228,222,2025-07-23 23:42:37.006139
753,1350,2022-09-29,205,54,248,194,2025-07-23 23:42:37.006788
754,764,2024-08-02,187,58,155,97,2025-07-23 23:42:37.007427
755,127,2023-10-25,155,41,462,421,2025-07-23 23:42:37.008054
756,1480,2022-10-07,94,124,284,160,2025-07-23 23:42:37.008689
757,683,2023-04-27,183,28,151,123,2025-07-23 23:42:37.009333
758,1278,2022-12-02,250,14,84,70,2025-07-23 23:42:37.009951
759,394,2024-02-07,93,282,317,35,2025-07-23 23:42:37.010559
760,1192,2024-08-22,126,224,447,223,2025-07-23 23:42:37.011188
761,1423,2024-01-31,139,354,360,6,2025-07-23 23:42:37.011813
762,888,2023-12-24,6,113,127,14,2025-07-23 23:42:37.012477
763,1071,2024-01-01,134,20,77,57,2025-07-23 23:42:37.013119
764,1070,2023-08-09,80,152,287,135,2025-07-23 23:42:37.013710
765,54,2022-10-27,145,208,409,201,2025-07-23 23:42:37.014339
766,990,2023-01-29,212,272,489,217,2025-07-23 23:42:37.014942
767,5,2023-12-11,125,351,370,19,2025-07-23 23:42:37.015545
768,951,2024-11-03,128,33,47,14,2025-07-23 23:42:37.016186
769,497,2024-05-14,156,270,411,141,2025-07-23 23:42:37.016802
770,906,2022-04-10,36,151,392,241,2025-07-23 23:42:37.017421
771,1476,2022-02-01,221,10,50,40,2025-07-23 23:42:37.018042
772,1485,2023-01-12,122,245,340,95,2025-07-23 23:42:37.018645
773,951,2023-07-29,79,104,115,11,2025-07-23 23:42:37.019276
774,1012,2022-03-07,136,204,225,21,2025-07-23 23:42:37.019888
775,428,2022-07-08,129,206,222,16,2025-07-23 23:42:37.020495
776,1026,2023-01-06,42,89,98,9,2025-07-23 23:42:37.021116
777,147,2022-01-09,149,139,468,329,2025-07-23 23:42:37.021705
778,729,2022-11-03,33,13,431,418,2025-07-23 23:42:37.022334
779,1425,2023-09-05,56,117,173,56,2025-07-23 23:42:37.022945
780,246,2023-04-07,56,10,23,13,2025-07-23 23:42:37.023556
781,240,2024-09-02,47,186,221,35,2025-07-23 23:42:37.024190
782,1211,2024-02-16,193,135,311,176,2025-07-23 23:42:37.024797
783,1148,2024-09-07,237,306,497,191,2025-07-23 23:42:37.025412
784,895,2023-02-03,22,151,326,175,2025-07-23 23:42:37.026053
785,689,2022-10-26,48,18,106,88,2025-07-23 23:42:37.026659
786,1056,2022-11-16,178,98,125,27,2025-07-23 23:42:37.027364
787,1032,2024-07-02,129,33,217,184,2025-07-23 23:42:37.028007
788,999,2023-10-09,1,29,34,5,2025-07-23 23:42:37.028638
789,1036,2023-09-15,202,95,468,373,2025-07-23 23:42:37.029338
790,1398,2024-11-02,83,45,53,8,2025-07-23 23:42:37.029951
791,866,2022-11-10,147,45,59,14,2025-07-23 23:42:37.030552
792,1086,2023-04-28,213,4,161,157,2025-07-23 23:42:37.031176
793,174,2024-01-15,25,41,64,23,2025-07-23 23:42:37.031782
794,1500,2024-12-22,33,177,185,8,2025-07-23 23:42:37.032394
795,162,2023-08-13,185,2,51,49,2025-07-23 23:42:37.033011
796,1462,2022-11-27,31,99,186,87,2025-07-23 23:42:37.033613
797,152,2022-01-09,87,302,312,10,2025-07-23 23:42:37.034258
798,243,2023-11-23,6,12,22,10,2025-07-23 23:42:37.034865
799,1043,2022-11-04,237,28,468,440,2025-07-23 23:42:37.035473
800,1351,2023-03-21,91,41,102,61,2025-07-23 23:42:37.036090
801,312,2023-11-23,242,26,500,474,2025-07-23 23:42:37.036674
802,42,2023-05-17,202,186,411,225,2025-07-23 23:42:37.037296
803,311,2024-02-08,33,31,66,35,2025-07-23 23:42:37.037899
804,899,2022-12-21,179,14,60,46,2025-07-23 23:42:37.038501
805,223,2024-08-23,43,191,298,107,2025-07-23 23:42:37.039122
806,143,2022-08-02,167,8,193,185,2025-07-23 23:42:37.039710
807,1361,2023-03-20,164,238,486,248,2025-07-23 23:42:37.040335
808,541,2023-09-21,248,57,71,14,2025-07-23 23:42:37.040944
809,936,2022-12-31,36,266,455,189,2025-07-23 23:42:37.041554
810,1224,2023-10-07,117,194,500,306,2025-07-23 23:42:37.042185
811,473,2022-06-09,94,9,39,30,2025-07-23 23:42:37.042795
812,1297,2023-12-03,126,101,283,182,2025-07-23 23:42:37.043412
813,425,2024-02-21,66,9,16,7,2025-07-23 23:42:37.044026
814,966,2022-10-20,61,387,468,81,2025-07-23 23:42:37.044652
815,1200,2022-07-13,55,11,300,289,2025-07-23 23:42:37.045361
816,1361,2024-05-28,103,370,426,56,2025-07-23 23:42:37.045996
817,1376,2022-04-05,237,325,392,67,2025-07-23 23:42:37.046598
818,82,2022-12-29,129,38,410,372,2025-07-23 23:42:37.047243
819,764,2024-05-21,170,40,383,343,2025-07-23 23:42:37.047855
820,1046,2024-09-05,237,457,467,10,2025-07-23 23:42:37.048462
821,187,2024-07-31,237,34,169,135,2025-07-23 23:42:37.049115
822,96,2022-10-24,172,10,16,6,2025-07-23 23:42:37.049716
823,891,2022-04-26,29,87,370,283,2025-07-23 23:42:37.050339
824,1390,2022-02-15,185,308,497,189,2025-07-23 23:42:37.050947
825,1082,2022-01-14,69,27,34,7,2025-07-23 23:42:37.051553
826,790,2023-01-27,212,58,65,7,2025-07-23 23:42:37.052177
827,1044,2022-04-12,37,326,407,81,2025-07-23 23:42:37.052774
828,127,2022-04-14,239,467,499,32,2025-07-23 23:42:37.053389
829,53,2023-12-17,42,33,59,26,2025-07-23 23:42:37.054012
830,352,2024-09-25,75,12,74,62,2025-07-23 23:42:37.054613
831,569,2023-02-28,25,33,185,152,2025-07-23 23:42:37.055245
832,263,2023-03-12,147,459,498,39,2025-07-23 23:42:37.055855
833,417,2023-04-26,70,164,287,123,2025-07-23 23:42:37.056463
834,595,2024-08-27,34,441,489,48,2025-07-23 23:42:37.057084
835,414,2022-12-08,168,3,464,461,2025-07-23 23:42:37.057677
836,340,2023-03-20,150,139,150,11,2025-07-23 23:42:37.058308
837,694,2024-12-05,138,50,142,92,2025-07-23 23:42:37.058926
838,1068,2023-06-30,147,27,432,405,2025-07-23 23:42:37.059532
839,377,2024-06-20,82,7,24,17,2025-07-23 23:42:37.060164
840,157,2023-04-02,145,83,162,79,2025-07-23 23:42:37.060852
841,941,2023-01-06,58,75,181,106,2025-07-23 23:42:37.061715
842,1049,2023-11-30,183,103,146,43,2025-07-23 23:42:37.062416
843,1013,2022-10-23,192,355,382,27,2025-07-23 23:42:37.063372
844,1328,2024-11-25,114,16,191,175,2025-07-23 23:42:37.064314
845,1372,2022-05-16,96,282,300,18,2025-07-23 23:42:37.065260
846,632,2024-08-10,178,17,123,106,2025-07-23 23:42:37.066213
847,1034,2023-08-14,74,13,19,6,2025-07-23 23:42:37.067167
848,879,2022-11-30,91,244,333,89,2025-07-23 23:42:37.068125
849,1341,2024-01-12,203,91,216,125,2025-07-23 23:42:37.069091
850,872,2023-09-11,130,133,322,189,2025-07-23 23:42:37.070038
851,65,2024-11-14,113,80,85,5,2025-07-23 23:42:37.071001
852,1385,2024-03-24,224,233,467,234,2025-07-23 23:42:37.071980
853,1117,2022-03-08,136,174,279,105,2025-07-23 23:42:37.072919
854,1410,2024-03-22,99,29,395,366,2025-07-23 23:42:37.073881
855,1016,2022-03-19,73,81,333,252,2025-07-23 23:42:37.074849
856,1125,2023-06-07,131,265,330,65,2025-07-23 23:42:37.075809
857,312,2023-09-05,196,6,160,154,2025-07-23 23:42:37.076753
858,815,2023-05-01,198,50,206,156,2025-07-23 23:42:37.077740
859,694,2024-04-03,94,175,283,108,2025-07-23 23:42:37.078709
860,459,2024-05-31,195,95,106,11,2025-07-23 23:42:37.079649
861,80,2022-11-04,46,64,69,5,2025-07-23 23:42:37.080601
862,1009,2024-12-29,35,404,468,64,2025-07-23 23:42:37.081549
863,426,2022-09-12,196,435,481,46,2025-07-23 23:42:37.082486
864,495,2022-10-06,114,51,313,262,2025-07-23 23:42:37.083526
865,1137,2024-01-29,126,141,198,57,2025-07-23 23:42:37.084489
866,877,2024-05-29,141,8,19,11,2025-07-23 23:42:37.085458
867,1132,2024-04-08,7,1,336,335,2025-07-23 23:42:37.086434
868,598,2023-02-17,123,44,51,7,2025-07-23 23:42:37.087409
869,470,2023-04-25,121,99,225,126,2025-07-23 23:42:37.088360
870,1375,2024-10-16,151,186,334,148,2025-07-23 23:42:37.089325
871,1290,2023-12-18,249,197,491,294,2025-07-23 23:42:37.090300
872,1182,2022-01-12,240,43,241,198,2025-07-23 23:42:37.091250
873,858,2024-08-09,90,49,63,14,2025-07-23 23:42:37.092203
874,1316,2024-05-25,141,364,443,79,2025-07-23 23:42:37.093160
875,1172,2024-03-20,54,204,473,269,2025-07-23 23:42:37.094129
876,1308,2022-06-18,91,329,494,165,2025-07-23 23:42:37.095088
877,1105,2022-09-15,184,191,224,33,2025-07-23 23:42:37.095997
878,630,2022-11-29,229,159,214,55,2025-07-23 23:42:37.096952
879,553,2022-10-04,138,348,388,40,2025-07-23 23:42:37.097892
880,425,2022-01-08,145,55,74,19,2025-07-23 23:42:37.098852
881,1034,2022-01-22,57,91,277,186,2025-07-23 23:42:37.100054
882,504,2023-09-24,110,24,123,99,2025-07-23 23:42:37.101134
883,209,2023-04-18,141,445,466,21,2025-07-23 23:42:37.102298
884,91,2023-04-07,207,159,302,143,2025-07-23 23:42:37.103414
885,1130,2022-12-01,12,103,132,29,2025-07-23 23:42:37.104451
886,705,2024-11-22,114,6,417,411,2025-07-23 23:42:37.105420
887,928,2024-01-20,9,259,372,113,2025-07-23 23:42:37.106401
888,1491,2023-05-04,214,252,435,183,2025-07-23 23:42:37.107400
889,231,2023-12-21,126,5,164,159,2025-07-23 23:42:37.108371
890,117,2024-02-25,79,35,103,68,2025-07-23 23:42:37.109397
891,788,2024-10-08,198,139,196,57,2025-07-23 23:42:37.110395
892,496,2023-12-31,73,82,170,88,2025-07-23 23:42:37.111390
893,1033,2023-01-24,35,31,174,143,2025-07-23 23:42:37.112633
894,500,2022-01-15,184,177,439,262,2025-07-23 23:42:37.113848
895,148,2024-03-23,62,38,58,20,2025-07-23 23:42:37.114907
896,1111,2022-06-16,19,161,353,192,2025-07-23 23:42:37.115893
897,753,2024-07-10,100,77,281,204,2025-07-23 23:42:37.116880
898,535,2022-10-04,197,125,164,39,2025-07-23 23:42:37.117878
899,1422,2024-12-16,154,117,468,351,2025-07-23 23:42:37.118872
900,478,2022-09-28,28,53,69,16,2025-07-23 23:42:37.119890
901,196,2023-10-31,155,146,161,15,2025-07-23 23:42:37.120870
902,1023,2023-10-31,151,116,477,361,2025-07-23 23:42:37.121878
903,1213,2022-06-17,193,7,169,162,2025-07-23 23:42:37.122866
904,29,2024-02-13,243,307,389,82,2025-07-23 23:42:37.123866
905,160,2024-10-01,88,112,491,379,2025-07-23 23:42:37.124860
906,1330,2022-05-31,244,308,376,68,2025-07-23 23:42:37.125864
907,230,2023-01-22,10,48,257,209,2025-07-23 23:42:37.126853
908,1184,2023-07-15,19,1,65,64,2025-07-23 23:42:37.127854
909,1273,2024-09-01,9,211,350,139,2025-07-23 23:42:37.128865
910,617,2022-12-03,111,331,411,80,2025-07-23 23:42:37.129870
911,809,2022-06-01,61,20,53,33,2025-07-23 23:42:37.130860
912,680,2022-12-22,82,168,397,229,2025-07-23 23:42:37.131841
913,223,2022-05-19,179,146,270,124,2025-07-23 23:42:37.132810
914,1186,2022-09-02,219,211,318,107,2025-07-23 23:42:37.133812
915,1437,2022-03-01,75,44,474,430,2025-07-23 23:42:37.134802
916,579,2024-09-02,56,32,200,168,2025-07-23 23:42:37.135946
917,1328,2023-01-24,70,419,436,17,2025-07-23 23:42:37.137051
918,919,2022-02-21,29,8,224,216,2025-07-23 23:42:37.138030
919,590,2023-01-24,34,138,478,340,2025-07-23 23:42:37.138997
920,1445,2022-09-24,233,424,437,13,2025-07-23 23:42:37.139982
921,1083,2023-02-12,61,238,453,215,2025-07-23 23:42:37.141146
922,1431,2022-04-01,200,209,473,264,2025-07-23 23:42:37.142242
923,1012,2022-05-18,23,32,39,7,2025-07-23 23:42:37.143227
924,1476,2024-05-20,194,60,272,212,2025-07-23 23:42:37.144186
925,767,2022-11-20,154,265,373,108,2025-07-23 23:42:37.145178
926,1126,2023-05-02,5,55,225,170,2025-07-23 23:42:37.146162
927,1299,2024-01-18,98,34,71,37,2025-07-23 23:42:37.147155
928,660,2022-02-18,194,211,420,209,2025-07-23 23:42:37.148127
929,1319,2023-01-13,204,256,416,160,2025-07-23 23:42:37.149116
930,337,2022-06-28,171,232,375,143,2025-07-23 23:42:37.150067
931,1076,2024-04-24,101,6,165,159,2025-07-23 23:42:37.151088
932,1346,2024-09-11,45,255,280,25,2025-07-23 23:42:37.152066
933,133,2024-02-03,246,0,50,50,2025-07-23 23:42:37.153049
934,1359,2024-02-16,160,69,81,12,2025-07-23 23:42:37.154001
935,943,2022-08-12,217,132,158,26,2025-07-23 23:42:37.155016
936,872,2024-03-08,87,10,343,333,2025-07-23 23:42:37.155967
937,1175,2022-08-25,88,3,397,394,2025-07-23 23:42:37.156936
938,1374,2022-12-16,189,125,166,41,2025-07-23 23:42:37.157868
939,1106,2023-04-30,162,5,483,478,2025-07-23 23:42:37.158841
940,1070,2024-07-18,136,39,163,124,2025-07-23 23:42:37.160058
941,579,2023-11-28,112,292,466,174,2025-07-23 23:42:37.161061
942,50,2023-07-21,45,39,85,46,2025-07-23 23:42:37.162048
943,195,2022-10-23,235,194,309,115,2025-07-23 23:42:37.163079
944,1471,2023-01-31,71,48,259,211,2025-07-23 23:42:37.164039
945,327,2024-11-05,16,47,464,417,2025-07-23 23:42:37.165015
946,202,2024-04-01,149,35,465,430,2025-07-23 23:42:37.165993
947,596,2024-02-14,12,46,64,18,2025-07-23 23:42:37.166957
948,1061,2022-12-26,106,364,449,85,2025-07-23 23:42:37.167893
949,380,2022-04-15,46,67,491,424,2025-07-23 23:42:37.169055
950,961,2024-03-30,18,174,201,27,2025-07-23 23:42:37.170317
951,990,2023-02-18,83,27,497,470,2025-07-23 23:42:37.171394
952,793,2023-03-02,28,48,433,385,2025-07-23 23:42:37.172497
953,801,2023-05-15,69,29,281,252,2025-07-23 23:42:37.173561
954,172,2024-10-05,231,11,289,278,2025-07-23 23:42:37.174619
955,879,2024-12-13,217,66,127,61,2025-07-23 23:42:37.175683
956,753,2022-10-19,119,75,458,383,2025-07-23 23:42:37.176728
957,643,2024-08-04,169,98,359,261,2025-07-23 23:42:37.177940
958,1008,2024-05-21,61,148,172,24,2025-07-23 23:42:37.178914
959,549,2023-08-03,34,62,122,60,2025-07-23 23:42:37.179868
960,658,2023-07-17,148,143,174,31,2025-07-23 23:42:37.180867
961,1149,2022-05-11,119,81,154,73,2025-07-23 23:42:37.181867
962,545,2022-10-27,97,196,311,115,2025-07-23 23:42:37.182867
963,1098,2024-03-19,142,84,113,29,2025-07-23 23:42:37.183859
964,713,2022-07-03,209,402,472,70,2025-07-23 23:42:37.184874
965,1399,2024-06-12,247,18,55,37,2025-07-23 23:42:37.185862
966,1162,2024-10-12,231,353,369,16,2025-07-23 23:42:37.186852
967,960,2023-03-19,219,9,28,19,2025-07-23 23:42:37.187821
968,1423,2024-12-21,87,41,170,129,2025-07-23 23:42:37.188833
969,629,2024-06-19,152,30,51,21,2025-07-23 23:42:37.189793
970,1322,2022-02-02,230,156,218,62,2025-07-23 23:42:37.190749
971,2,2022-01-10,140,193,424,231,2025-07-23 23:42:37.191729
972,1254,2024-08-03,56,62,136,74,2025-07-23 23:42:37.192699
973,532,2023-03-29,134,2,131,129,2025-07-23 23:42:37.193679
974,650,2022-06-27,21,20,105,85,2025-07-23 23:42:37.194620
975,117,2023-01-30,249,56,386,330,2025-07-23 23:42:37.195613
976,658,2024-05-20,168,283,382,99,2025-07-23 23:42:37.196855
977,1385,2022-12-01,68,0,371,371,2025-07-23 23:42:37.197931
978,1379,2024-06-13,8,32,43,11,2025-07-23 23:42:37.198898
979,128,2023-05-19,95,57,64,7,2025-07-23 23:42:37.199878
980,668,2023-11-25,59,66,359,293,2025-07-23 23:42:37.200863
981,891,2023-02-03,182,18,38,20,2025-07-23 23:42:37.201860
982,836,2022-09-12,112,21,59,38,2025-07-23 23:42:37.203020
983,525,2023-02-12,148,16,21,5,2025-07-23 23:42:37.204452
984,1046,2023-01-11,106,90,191,101,2025-07-23 23:42:37.205553
985,1396,2024-11-20,118,193,457,264,2025-07-23 23:42:37.206705
986,601,2023-10-04,98,239,496,257,2025-07-23 23:42:37.207722
987,49,2022-08-17,68,169,260,91,2025-07-23 23:42:37.208877
988,668,2022-05-08,82,11,52,41,2025-07-23 23:42:37.209865
989,137,2024-08-15,96,196,218,22,2025-07-23 23:42:37.210864
990,1147,2022-10-20,72,120,234,114,2025-07-23 23:42:37.211858
991,156,2024-11-13,45,267,302,35,2025-07-23 23:42:37.212876
992,408,2022-06-07,64,288,333,45,2025-07-23 23:42:37.213874
993,705,2024-09-16,241,467,491,24,2025-07-23 23:42:37.214874
994,616,2023-12-29,59,356,413,57,2025-07-23 23:42:37.215864
995,587,2024-04-07,240,263,292,29,2025-07-23 23:42:37.216868
996,713,2024-03-25,143,4,33,29,2025-07-23 23:42:37.217851
997,129,2023-11-03,239,3,14,11,2025-07-23 23:42:37.218834
998,624,2022-11-23,244,1,12,11,2025-07-23 23:42:37.219819
999,631,2024-03-01,130,100,194,94,2025-07-23 23:42:37.220820
1000,325,2022-02-16,224,122,245,123,2025-07-23 23:42:37.221816
1001,481,2024-03-27,187,174,358,184,2025-07-23 23:42:37.222826
1002,1316,2023-02-11,181,169,372,203,2025-07-23 23:42:37.223813
1003,1355,2023-09-22,168,70,487,417,2025-07-23 23:42:37.224796
1004,367,2022-07-25,38,39,91,52,2025-07-23 23:42:37.225746
1005,1459,2023-07-08,165,301,312,11,2025-07-23 23:42:37.226734
1006,264,2022-08-10,16,73,214,141,2025-07-23 23:42:37.227705
1007,841,2022-09-05,18,19,206,187,2025-07-23 23:42:37.228684
1008,680,2024-05-29,97,17,74,57,2025-07-23 23:42:37.229634
1009,1491,2023-06-28,22,11,35,24,2025-07-23 23:42:37.230876
1010,301,2023-11-23,48,117,141,24,2025-07-23 23:42:37.231940
1011,765,2023-01-30,96,151,219,68,2025-07-23 23:42:37.232905
1012,798,2022-10-07,55,50,60,10,2025-07-23 23:42:37.233873
1013,888,2022-05-29,182,259,266,7,2025-07-23 23:42:37.235030
1014,753,2023-12-02,190,346,419,73,2025-07-23 23:42:37.236084
1015,705,2023-01-26,194,6,13,7,2025-07-23 23:42:37.237042
1016,55,2023-12-31,80,243,467,224,2025-07-23 23:42:37.238037
1017,1216,2024-10-02,98,191,314,123,2025-07-23 23:42:37.239024
1018,1386,2024-02-04,19,58,194,136,2025-07-23 23:42:37.240017
1019,703,2024-09-20,228,61,339,278,2025-07-23 23:42:37.241003
1020,478,2024-05-18,250,74,391,317,2025-07-23 23:42:37.242060
1021,9,2023-12-25,226,76,209,133,2025-07-23 23:42:37.243073
1022,260,2022-01-10,161,138,220,82,2025-07-23 23:42:37.244051
1023,217,2022-09-01,202,41,180,139,2025-07-23 23:42:37.245020
1024,1311,2023-12-17,125,19,210,191,2025-07-23 23:42:37.245989
1025,547,2024-02-24,90,0,381,381,2025-07-23 23:42:37.246939
1026,592,2023-10-31,158,77,297,220,2025-07-23 23:42:37.247865
1027,1042,2024-03-12,195,108,133,25,2025-07-23 23:42:37.248853
1028,345,2023-08-29,222,147,162,15,2025-07-23 23:42:37.249805
1029,183,2023-02-15,151,97,165,68,2025-07-23 23:42:37.250749
1030,1075,2024-01-11,84,68,412,344,2025-07-23 23:42:37.251704
1031,174,2022-10-31,42,67,104,37,2025-07-23 23:42:37.252645
1032,1437,2024-10-23,92,352,454,102,2025-07-23 23:42:37.253601
1033,1034,2023-04-22,144,106,153,47,2025-07-23 23:42:37.254552
1034,1034,2022-01-23,228,330,335,5,2025-07-23 23:42:37.255492
1035,1330,2023-11-11,136,63,433,370,2025-07-23 23:42:37.256446
1036,813,2023-12-07,129,217,270,53,2025-07-23 23:42:37.257405
1037,165,2023-04-08,206,235,471,236,2025-07-23 23:42:37.258347
1038,1362,2024-09-25,211,42,97,55,2025-07-23 23:42:37.259482
1039,1015,2024-11-18,96,332,350,18,2025-07-23 23:42:37.260734
1040,136,2022-04-23,250,15,118,103,2025-07-23 23:42:37.261569
1041,653,2024-11-20,170,204,258,54,2025-07-23 23:42:37.262422
1042,1359,2022-04-14,39,36,262,226,2025-07-23 23:42:37.263223
1043,969,2023-04-26,126,33,145,112,2025-07-23 23:42:37.264055
1044,96,2022-09-15,202,126,385,259,2025-07-23 23:42:37.264827
1045,679,2024-01-05,143,79,92,13,2025-07-23 23:42:37.265483
1046,679,2023-04-27,139,95,207,112,2025-07-23 23:42:37.266436
1047,1243,2023-01-02,182,6,33,27,2025-07-23 23:42:37.267277
1048,1418,2023-03-17,42,51,59,8,2025-07-23 23:42:37.268027
1049,848,2024-03-17,145,1,37,36,2025-07-23 23:42:37.268876
1050,533,2022-12-07,108,164,343,179,2025-07-23 23:42:37.269785
1051,564,2024-07-05,164,4,134,130,2025-07-23 23:42:37.271007
1052,409,2022-08-03,40,215,329,114,2025-07-23 23:42:37.271906
1053,418,2023-01-28,37,185,234,49,2025-07-23 23:42:37.272636
1054,209,2023-07-15,177,6,248,242,2025-07-23 23:42:37.273528
1055,584,2023-01-24,135,174,370,196,2025-07-23 23:42:37.274358
1056,199,2023-09-21,168,182,207,25,2025-07-23 23:42:37.275122
1057,1145,2024-07-10,156,54,130,76,2025-07-23 23:42:37.275730
1058,446,2024-01-04,45,171,357,186,2025-07-23 23:42:37.276424
1059,1277,2022-05-23,37,42,104,62,2025-07-23 23:42:37.277105
1060,828,2023-12-21,206,255,480,225,2025-07-23 23:42:37.277883
1061,650,2024-06-21,135,27,249,222,2025-07-23 23:42:37.278654
1062,700,2023-08-14,10,269,461,192,2025-07-23 23:42:37.279384
1063,993,2023-03-18,37,250,493,243,2025-07-23 23:42:37.280077
1064,1483,2024-03-19,145,322,407,85,2025-07-23 23:42:37.280748
1065,678,2022-05-09,219,120,190,70,2025-07-23 23:42:37.281877
1066,929,2024-05-23,55,199,315,116,2025-07-23 23:42:37.282964
1067,161,2023-01-03,82,43,68,25,2025-07-23 23:42:37.283971
1068,751,2024-05-02,166,83,100,17,2025-07-23 23:42:37.284983
1069,410,2024-10-24,134,35,57,22,2025-07-23 23:42:37.285990
1070,474,2023-11-13,13,29,148,119,2025-07-23 23:42:37.286912
1071,758,2022-02-08,232,99,312,213,2025-07-23 23:42:37.287855
1072,1208,2023-05-01,222,61,294,233,2025-07-23 23:42:37.288966
1073,13,2022-07-01,98,288,477,189,2025-07-23 23:42:37.289929
1074,1391,2023-12-07,229,3,109,106,2025-07-23 23:42:37.290911
1075,118,2022-12-22,133,8,44,36,2025-07-23 23:42:37.291938
1076,155,2023-08-18,35,26,143,117,2025-07-23 23:42:37.292926
1077,768,2022-06-09,41,35,463,428,2025-07-23 23:42:37.293925
1078,1173,2022-10-17,18,78,164,86,2025-07-23 23:42:37.294939
1079,1415,2022-09-14,29,212,352,140,2025-07-23 23:42:37.295905
1080,646,2024-10-20,234,409,436,27,2025-07-23 23:42:37.296923
1081,394,2024-10-11,70,127,140,13,2025-07-23 23:42:37.297957
1082,1039,2024-06-12,88,290,437,147,2025-07-23 23:42:37.298955
1083,200,2024-12-04,66,152,226,74,2025-07-23 23:42:37.299933
1084,566,2023-01-07,197,174,283,109,2025-07-23 23:42:37.300906
1085,339,2022-11-23,144,120,165,45,2025-07-23 23:42:37.301875
1086,1109,2024-02-21,223,5,21,16,2025-07-23 23:42:37.302848
1087,167,2023-03-12,86,109,320,211,2025-07-23 23:42:37.303794
1088,503,2024-09-30,151,355,472,117,2025-07-23 23:42:37.304738
1089,1240,2024-06-25,66,88,329,241,2025-07-23 23:42:37.305680
1090,747,2022-01-01,121,76,108,32,2025-07-23 23:42:37.306612
1091,967,2022-09-01,148,166,403,237,2025-07-23 23:42:37.307569
1092,835,2023-07-23,115,20,209,189,2025-07-23 23:42:37.308503
1093,272,2023-04-10,201,442,457,15,2025-07-23 23:42:37.309475
1094,1417,2023-06-24,145,12,275,263,2025-07-23 23:42:37.310445
1095,1041,2022-07-20,172,165,229,64,2025-07-23 23:42:37.311392
1096,1425,2024-12-09,38,31,114,83,2025-07-23 23:42:37.312322
1097,840,2024-12-05,73,191,255,64,2025-07-23 23:42:37.313280
1098,667,2023-08-31,14,2,13,11,2025-07-23 23:42:37.314206
1099,1445,2022-01-14,181,69,264,195,2025-07-23 23:42:37.315169
1100,490,2023-12-04,217,10,15,5,2025-07-23 23:42:37.316091
1101,484,2023-11-18,107,134,275,141,2025-07-23 23:42:37.317037
1102,1400,2023-11-18,120,262,346,84,2025-07-23 23:42:37.317989
1103,362,2022-08-22,176,136,142,6,2025-07-23 23:42:37.318922
1104,421,2024-09-22,235,125,220,95,2025-07-23 23:42:37.319865
1105,1232,2024-09-27,74,3,44,41,2025-07-23 23:42:37.320852
1106,78,2023-04-12,4,13,37,24,2025-07-23 23:42:37.321817
1107,888,2024-07-30,60,146,282,136,2025-07-23 23:42:37.322807
1108,911,2022-01-03,46,61,82,21,2025-07-23 23:42:37.323741
1109,1054,2024-07-05,97,23,272,249,2025-07-23 23:42:37.324680
1110,459,2024-09-18,223,24,129,105,2025-07-23 23:42:37.325624
1111,590,2023-04-25,98,42,278,236,2025-07-23 23:42:37.326568
1112,399,2024-06-15,189,14,200,186,2025-07-23 23:42:37.327507
1113,196,2022-09-14,69,50,287,237,2025-07-23 23:42:37.328448
1114,757,2023-08-25,210,55,84,29,2025-07-23 23:42:37.329430
1115,1433,2024-01-27,22,200,231,31,2025-07-23 23:42:37.330380
1116,633,2022-01-12,68,42,157,115,2025-07-23 23:42:37.331307
1117,508,2024-02-14,28,268,299,31,2025-07-23 23:42:37.332243
1118,386,2022-04-27,78,52,247,195,2025-07-23 23:42:37.333206
1119,834,2022-05-20,35,299,498,199,2025-07-23 23:42:37.334142
1120,1086,2023-03-08,29,288,460,172,2025-07-23 23:42:37.335041
1121,1021,2024-06-21,169,205,276,71,2025-07-23 23:42:37.336008
1122,19,2024-10-27,187,257,286,29,2025-07-23 23:42:37.336943
1123,1203,2023-11-28,227,58,68,10,2025-07-23 23:42:37.337884
1124,930,2022-03-19,95,17,389,372,2025-07-23 23:42:37.338857
1125,85,2024-04-03,227,137,453,316,2025-07-23 23:42:37.339842
1126,20,2022-06-06,77,116,183,67,2025-07-23 23:42:37.340809
1127,1388,2022-04-29,171,35,47,12,2025-07-23 23:42:37.341790
1128,1358,2023-03-09,85,48,379,331,2025-07-23 23:42:37.342729
1129,1084,2022-08-09,187,132,414,282,2025-07-23 23:42:37.343689
1130,530,2024-10-19,149,29,119,90,2025-07-23 23:42:37.344662
1131,1206,2023-05-10,25,15,92,77,2025-07-23 23:42:37.345608
1132,135,2023-07-13,217,47,350,303,2025-07-23 23:42:37.346592
1133,317,2022-06-24,144,123,396,273,2025-07-23 23:42:37.347550
1134,1017,2023-04-22,14,134,197,63,2025-07-23 23:42:37.348481
1135,783,2022-12-07,228,32,124,92,2025-07-23 23:42:37.349510
1136,477,2023-10-03,128,21,165,144,2025-07-23 23:42:37.350477
1137,1128,2022-02-15,133,113,121,8,2025-07-23 23:42:37.351453
1138,1280,2023-04-07,91,56,370,314,2025-07-23 23:42:37.352436
1139,996,2022-10-21,61,266,455,189,2025-07-23 23:42:37.353415
1140,962,2024-08-06,212,19,127,108,2025-07-23 23:42:37.354344
1141,748,2024-08-10,185,197,219,22,2025-07-23 23:42:37.355307
1142,1499,2023-02-10,112,17,43,26,2025-07-23 23:42:37.356294
1143,556,2022-11-04,224,375,433,58,2025-07-23 23:42:37.357270
1144,921,2024-03-25,84,20,340,320,2025-07-23 23:42:37.358223
1145,576,2023-01-02,163,123,228,105,2025-07-23 23:42:37.359179
1146,361,2022-09-19,33,227,341,114,2025-07-23 23:42:37.360161
1147,1260,2023-12-28,131,246,346,100,2025-07-23 23:42:37.361149
1148,1276,2024-07-07,28,230,235,5,2025-07-23 23:42:37.362141
1149,448,2023-03-14,241,172,248,76,2025-07-23 23:42:37.363114
1150,375,2024-11-05,69,51,466,415,2025-07-23 23:42:37.364026
1151,804,2022-10-05,101,183,230,47,2025-07-23 23:42:37.364978
1152,675,2024-12-21,66,180,326,146,2025-07-23 23:42:37.365930
1153,404,2022-09-17,105,205,220,15,2025-07-23 23:42:37.366872
1154,959,2024-03-21,179,34,147,113,2025-07-23 23:42:37.367812
1155,216,2023-11-15,84,23,40,17,2025-07-23 23:42:37.368800
1156,704,2022-06-11,72,195,396,201,2025-07-23 23:42:37.370006
1157,1274,2022-03-17,220,104,317,213,2025-07-23 23:42:37.371065
1158,1377,2024-12-02,59,11,447,436,2025-07-23 23:42:37.372029
1159,848,2024-05-04,168,239,266,27,2025-07-23 23:42:37.373202
1160,1270,2024-08-27,27,277,287,10,2025-07-23 23:42:37.374313
1161,318,2022-04-19,46,5,90,85,2025-07-23 23:42:37.375297
1162,864,2022-05-21,233,27,270,243,2025-07-23 23:42:37.376298
1163,890,2024-04-12,197,55,69,14,2025-07-23 23:42:37.377281
1164,1102,2024-06-17,217,9,19,10,2025-07-23 23:42:37.378217
1165,1146,2022-03-23,99,3,227,224,2025-07-23 23:42:37.379146
1166,871,2023-07-25,61,113,291,178,2025-07-23 23:42:37.380308
1167,194,2024-09-30,24,123,192,69,2025-07-23 23:42:37.381382
1168,333,2022-03-07,59,61,114,53,2025-07-23 23:42:37.382347
1169,1221,2023-09-05,99,85,106,21,2025-07-23 23:42:37.383313
1170,990,2023-08-24,173,23,418,395,2025-07-23 23:42:37.384286
1171,1198,2022-12-04,220,15,488,473,2025-07-23 23:42:37.385414
1172,754,2023-08-31,41,75,370,295,2025-07-23 23:42:37.386507
1173,1263,2024-06-28,145,49,223,174,2025-07-23 23:42:37.387537
1174,774,2024-06-02,53,58,165,107,2025-07-23 23:42:37.388555
1175,521,2023-03-22,224,56,273,217,2025-07-23 23:42:37.389540
1176,1070,2022-05-16,186,178,425,247,2025-07-23 23:42:37.390505
1177,356,2023-12-02,23,118,393,275,2025-07-23 23:42:37.391436
1178,598,2024-10-31,68,170,273,103,2025-07-23 23:42:37.392400
1179,796,2022-07-27,16,78,152,74,2025-07-23 23:42:37.393403
1180,288,2024-02-19,248,131,212,81,2025-07-23 23:42:37.394333
1181,489,2023-05-03,195,468,493,25,2025-07-23 23:42:37.395280
1182,187,2023-12-01,191,199,300,101,2025-07-23 23:42:37.396245
1183,1093,2024-01-03,229,103,305,202,2025-07-23 23:42:37.397182
1184,1061,2023-10-21,40,17,43,26,2025-07-23 23:42:37.398178
1185,1268,2022-07-08,226,9,147,138,2025-07-23 23:42:37.399113
1186,826,2023-05-16,50,103,310,207,2025-07-23 23:42:37.400042
1187,299,2024-06-24,70,74,104,30,2025-07-23 23:42:37.400988
1188,788,2024-01-02,42,203,332,129,2025-07-23 23:42:37.401925
1189,1070,2024-04-21,151,323,432,109,2025-07-23 23:42:37.402875
1190,1026,2023-12-20,162,51,117,66,2025-07-23 23:42:37.403847
1191,680,2024-03-22,197,15,263,248,2025-07-23 23:42:37.404799
1192,560,2022-02-21,117,405,482,77,2025-07-23 23:42:37.405814
1193,1407,2023-01-23,128,200,321,121,2025-07-23 23:42:37.406777
1194,1232,2022-09-09,63,88,212,124,2025-07-23 23:42:37.407723
1195,429,2023-06-30,101,79,270,191,2025-07-23 23:42:37.408684
1196,396,2024-05-26,78,271,311,40,2025-07-23 23:42:37.409621
1197,197,2024-07-30,169,116,430,314,2025-07-23 23:42:37.410591
1198,1331,2023-09-28,204,35,61,26,2025-07-23 23:42:37.411555
1199,1231,2022-06-16,243,174,375,201,2025-07-23 23:42:37.412520
1200,1355,2023-02-10,149,142,401,259,2025-07-23 23:42:37.413481
1201,245,2023-10-17,219,6,27,21,2025-07-23 23:42:37.414461
1202,1160,2022-01-27,243,304,415,111,2025-07-23 23:42:37.415451
1203,1132,2024-02-26,72,308,494,186,2025-07-23 23:42:37.416430
1204,755,2024-09-28,12,15,33,18,2025-07-23 23:42:37.417391
1205,1128,2024-04-09,108,52,200,148,2025-07-23 23:42:37.418340
1206,469,2023-09-23,144,26,84,58,2025-07-23 23:42:37.419306
1207,773,2023-04-27,112,303,463,160,2025-07-23 23:42:37.420266
1208,336,2022-04-28,156,131,166,35,2025-07-23 23:42:37.421217
1209,963,2024-03-08,239,124,307,183,2025-07-23 23:42:37.422191
1210,1075,2024-09-27,73,178,240,62,2025-07-23 23:42:37.423391
1211,366,2024-03-27,203,124,226,102,2025-07-23 23:42:37.424485
1212,520,2024-05-02,184,3,15,12,2025-07-23 23:42:37.425488
1213,1183,2022-08-11,95,177,256,79,2025-07-23 23:42:37.426463
1214,982,2022-04-26,202,231,311,80,2025-07-23 23:42:37.427430
1215,1296,2024-10-27,21,34,244,210,2025-07-23 23:42:37.428426
1216,239,2024-10-10,147,28,95,67,2025-07-23 23:42:37.429444
1217,786,2024-08-20,131,128,142,14,2025-07-23 23:42:37.430630
1218,797,2022-05-24,196,36,62,26,2025-07-23 23:42:37.431707
1219,386,2024-05-19,36,47,496,449,2025-07-23 23:42:37.432678
1220,1172,2023-01-17,62,25,186,161,2025-07-23 23:42:37.433671
1221,685,2024-07-11,226,128,331,203,2025-07-23 23:42:37.434664
1222,1261,2023-10-06,9,168,224,56,2025-07-23 23:42:37.435604
1223,82,2023-11-30,135,94,483,389,2025-07-23 23:42:37.436588
1224,68,2023-08-28,167,14,299,285,2025-07-23 23:42:37.437560
1225,1391,2024-05-09,131,30,164,134,2025-07-23 23:42:37.438530
1226,851,2023-06-05,144,0,100,100,2025-07-23 23:42:37.439501
1227,745,2022-03-19,221,179,268,89,2025-07-23 23:42:37.440494
1228,898,2022-04-28,118,71,421,350,2025-07-23 23:42:37.441455
1229,749,2023-07-23,140,64,141,77,2025-07-23 23:42:37.442779
1230,398,2024-12-08,26,252,438,186,2025-07-23 23:42:37.444049
1231,624,2024-04-18,230,161,185,24,2025-07-23 23:42:37.445075
1232,144,2022-10-20,34,322,375,53,2025-07-23 23:42:37.446105
1233,713,2022-08-21,95,249,287,38,2025-07-23 23:42:37.447075
1234,134,2023-08-19,117,222,349,127,2025-07-23 23:42:37.448038
1235,185,2023-11-21,246,83,327,244,2025-07-23 23:42:37.449024
1236,917,2023-08-15,3,57,132,75,2025-07-23 23:42:37.449988
1237,254,2023-02-28,88,106,255,149,2025-07-23 23:42:37.450949
1238,36,2022-03-21,77,1,201,200,2025-07-23 23:42:37.451869
1239,980,2022-11-03,150,109,249,140,2025-07-23 23:42:37.452850
1240,327,2024-06-26,18,75,442,367,2025-07-23 23:42:37.453823
1241,4,2022-10-08,37,25,54,29,2025-07-23 23:42:37.454782
1242,961,2023-09-21,148,120,436,316,2025-07-23 23:42:37.455727
1243,219,2022-07-14,204,120,430,310,2025-07-23 23:42:37.457298
1244,831,2024-11-24,242,38,211,173,2025-07-23 23:42:37.458346
1245,1132,2022-06-28,199,272,288,16,2025-07-23 23:42:37.459309
1246,260,2024-04-15,217,9,479,470,2025-07-23 23:42:37.460742
1247,983,2023-06-04,177,21,371,350,2025-07-23 23:42:37.461895
1248,435,2022-10-06,217,34,434,400,2025-07-23 23:42:37.462998
1249,537,2024-03-26,129,1,85,84,2025-07-23 23:42:37.464041
1250,17,2023-05-27,84,109,215,106,2025-07-23 23:42:37.465071
1251,763,2022-02-22,66,292,475,183,2025-07-23 23:42:37.466118
1252,177,2022-03-17,101,1,101,100,2025-07-23 23:42:37.467179
1253,503,2023-01-09,192,7,45,38,2025-07-23 23:42:37.468232
1254,1488,2023-09-09,36,2,95,93,2025-07-23 23:42:37.469276
1255,217,2023-04-28,179,68,486,418,2025-07-23 23:42:37.470332
1256,369,2022-10-20,51,380,431,51,2025-07-23 23:42:37.471366
1257,1031,2023-11-10,231,120,170,50,2025-07-23 23:42:37.472392
1258,1027,2022-02-11,204,184,195,11,2025-07-23 23:42:37.473414
1259,243,2022-09-12,79,243,297,54,2025-07-23 23:42:37.474444
1260,394,2023-03-28,133,37,243,206,2025-07-23 23:42:37.475496
1261,70,2022-10-18,20,47,69,22,2025-07-23 23:42:37.476534
1262,759,2022-04-18,202,430,457,27,2025-07-23 23:42:37.477548
1263,1089,2023-12-14,75,26,60,34,2025-07-23 23:42:37.478562
1264,23,2023-01-26,84,137,187,50,2025-07-23 23:42:37.479641
1265,1119,2023-04-20,204,18,320,302,2025-07-23 23:42:37.480688
1266,408,2024-03-01,245,103,178,75,2025-07-23 23:42:37.481709
1267,1146,2022-08-05,49,78,122,44,2025-07-23 23:42:37.482792
1268,526,2022-02-18,172,34,127,93,2025-07-23 23:42:37.483908
1269,651,2022-06-05,168,135,480,345,2025-07-23 23:42:37.484932
1270,614,2024-12-19,35,241,441,200,2025-07-23 23:42:37.485969
1271,1100,2023-09-24,14,6,307,301,2025-07-23 23:42:37.487011
1272,1305,2023-05-19,223,280,372,92,2025-07-23 23:42:37.488044
1273,99,2023-04-27,113,11,319,308,2025-07-23 23:42:37.489211
1274,855,2023-09-16,146,20,35,15,2025-07-23 23:42:37.490247
1275,59,2024-04-18,85,67,119,52,2025-07-23 23:42:37.491267
1276,1417,2024-11-27,192,32,335,303,2025-07-23 23:42:37.492302
1277,47,2024-05-21,229,15,319,304,2025-07-23 23:42:37.493359
1278,372,2023-12-05,156,144,177,33,2025-07-23 23:42:37.494360
1279,1271,2024-12-15,223,175,205,30,2025-07-23 23:42:37.495374
1280,152,2022-01-02,62,80,345,265,2025-07-23 23:42:37.496383
1281,7,2024-04-16,207,57,431,374,2025-07-23 23:42:37.497395
1282,294,2022-05-03,13,77,113,36,2025-07-23 23:42:37.498449
1283,478,2022-09-03,191,107,324,217,2025-07-23 23:42:37.499522
1284,1361,2022-06-26,216,16,70,54,2025-07-23 23:42:37.500557
1285,54,2022-08-19,75,466,498,32,2025-07-23 23:42:37.501627
1286,816,2023-01-30,69,70,345,275,2025-07-23 23:42:37.502655
1287,286,2023-01-26,239,426,500,74,2025-07-23 23:42:37.503700
1288,1171,2022-01-26,247,186,243,57,2025-07-23 23:42:37.504891
1289,580,2024-11-11,235,31,64,33,2025-07-23 23:42:37.505941
1290,1102,2022-03-03,35,116,295,179,2025-07-23 23:42:37.506885
1291,645,2022-12-25,150,129,155,26,2025-07-23 23:42:37.507870
1292,637,2022-04-30,119,25,187,162,2025-07-23 23:42:37.508865
1293,1145,2024-06-25,119,47,65,18,2025-07-23 23:42:37.509838
1294,949,2024-05-11,172,10,31,21,2025-07-23 23:42:37.510752
1295,1309,2024-06-21,191,11,127,116,2025-07-23 23:42:37.511694
1296,1147,2022-04-18,196,95,141,46,2025-07-23 23:42:37.512617
1297,547,2022-06-24,238,3,43,40,2025-07-23 23:42:37.513562
1298,147,2024-02-06,78,126,236,110,2025-07-23 23:42:37.514488
1299,1026,2022-07-15,244,270,415,145,2025-07-23 23:42:37.515454
1300,1445,2022-07-16,13,280,439,159,2025-07-23 23:42:37.516400
1301,1060,2022-05-28,131,34,154,120,2025-07-23 23:42:37.517329
1302,489,2023-10-19,125,361,435,74,2025-07-23 23:42:37.518278
1303,1256,2023-05-01,249,24,57,33,2025-07-23 23:42:37.519212
1304,995,2022-10-31,47,47,65,18,2025-07-23 23:42:37.520148
1305,594,2024-08-21,133,179,222,43,2025-07-23 23:42:37.521351
1306,135,2023-04-17,136,12,76,64,2025-07-23 23:42:37.522341
1307,588,2024-08-02,170,13,182,169,2025-07-23 23:42:37.523417
1308,43,2024-05-25,217,34,390,356,2025-07-23 23:42:37.524401
1309,978,2023-02-18,204,344,387,43,2025-07-23 23:42:37.525526
1310,816,2024-10-29,205,1,37,36,2025-07-23 23:42:37.526702
1311,1022,2024-12-21,17,138,456,318,2025-07-23 23:42:37.527665
1312,1432,2024-10-07,152,79,190,111,2025-07-23 23:42:37.528718
1313,1354,2022-04-01,187,470,485,15,2025-07-23 23:42:37.529704
1314,1383,2023-08-08,142,32,88,56,2025-07-23 23:42:37.530953
1315,370,2022-12-13,34,30,67,37,2025-07-23 23:42:37.532029
1316,550,2023-03-07,36,365,415,50,2025-07-23 23:42:37.532991
1317,1235,2023-11-23,68,129,207,78,2025-07-23 23:42:37.533971
1318,737,2023-08-04,105,66,156,90,2025-07-23 23:42:37.534916
1319,564,2023-02-15,56,159,198,39,2025-07-23 23:42:37.535878
1320,794,2024-03-22,3,130,195,65,2025-07-23 23:42:37.536868
1321,534,2024-06-22,13,74,199,125,2025-07-23 23:42:37.537863
1322,946,2024-10-07,173,68,74,6,2025-07-23 23:42:37.538855
1323,1236,2024-12-24,8,192,273,81,2025-07-23 23:42:37.539825
1324,382,2024-02-29,87,32,256,224,2025-07-23 23:42:37.540793
1325,190,2024-02-11,87,51,434,383,2025-07-23 23:42:37.541993
1326,426,2022-08-29,158,352,480,128,2025-07-23 23:42:37.542998
1327,788,2024-09-29,188,52,264,212,2025-07-23 23:42:37.543990
1328,772,2022-01-20,1,62,117,55,2025-07-23 23:42:37.544989
1329,983,2024-09-03,162,17,475,458,2025-07-23 23:42:37.546130
1330,763,2023-02-01,172,377,396,19,2025-07-23 23:42:37.547148
1331,987,2024-11-19,250,116,166,50,2025-07-23 23:42:37.548099
1332,1033,2023-01-13,7,4,78,74,2025-07-23 23:42:37.549234
1333,1158,2023-11-09,49,155,254,99,2025-07-23 23:42:37.550191
1334,187,2022-07-26,5,62,78,16,2025-07-23 23:42:37.551182
1335,932,2023-07-30,240,51,205,154,2025-07-23 23:42:37.552161
1336,1368,2023-10-28,235,71,161,90,2025-07-23 23:42:37.553152
1337,1149,2024-06-04,240,159,283,124,2025-07-23 23:42:37.554144
1338,1403,2024-08-31,128,120,194,74,2025-07-23 23:42:37.555133
1339,604,2022-10-15,184,14,27,13,2025-07-23 23:42:37.556271
1340,564,2023-01-17,144,65,128,63,2025-07-23 23:42:37.557269
1341,1428,2022-06-30,4,316,406,90,2025-07-23 23:42:37.558234
1342,990,2024-08-10,149,155,300,145,2025-07-23 23:42:37.559502
1343,828,2023-11-05,24,198,243,45,2025-07-23 23:42:37.560543
1344,42,2023-02-22,201,158,340,182,2025-07-23 23:42:37.561547
1345,871,2023-01-16,206,159,372,213,2025-07-23 23:42:37.562543
1346,960,2022-11-15,2,266,302,36,2025-07-23 23:42:37.563523
1347,1044,2024-06-26,21,28,35,7,2025-07-23 23:42:37.564496
1348,563,2024-10-10,179,433,447,14,2025-07-23 23:42:37.565486
1349,400,2022-06-03,40,186,458,272,2025-07-23 23:42:37.566498
1350,78,2023-10-22,126,3,12,9,2025-07-23 23:42:37.567510
1351,763,2023-03-06,171,181,375,194,2025-07-23 23:42:37.568498
1352,695,2023-07-28,32,244,298,54,2025-07-23 23:42:37.569495
1353,1139,2022-05-24,64,23,29,6,2025-07-23 23:42:37.570469
1354,663,2022-01-22,182,148,186,38,2025-07-23 23:42:37.571465
1355,582,2024-09-06,231,282,380,98,2025-07-23 23:42:37.572447
1356,1278,2024-10-13,219,28,48,20,2025-07-23 23:42:37.573475
1357,1368,2024-01-28,13,67,122,55,2025-07-23 23:42:37.574497
1358,424,2022-09-14,26,128,139,11,2025-07-23 23:42:37.575498
1359,185,2023-05-30,193,0,126,126,2025-07-23 23:42:37.576510
1360,275,2024-09-29,12,126,267,141,2025-07-23 23:42:37.577540
1361,1446,2023-03-08,89,26,376,350,2025-07-23 23:42:37.578508
1362,410,2022-04-28,156,81,195,114,2025-07-23 23:42:37.579496
1363,777,2024-01-08,168,147,176,29,2025-07-23 23:42:37.580482
1364,1469,2022-07-19,210,177,215,38,2025-07-23 23:42:37.581465
1365,595,2022-04-15,92,19,100,81,2025-07-23 23:42:37.582454
1366,656,2024-05-03,221,172,218,46,2025-07-23 23:42:37.583436
1367,1343,2023-09-28,224,307,324,17,2025-07-23 23:42:37.584441
1368,573,2024-10-24,189,15,100,85,2025-07-23 23:42:37.585420
1369,1307,2022-02-21,240,92,165,73,2025-07-23 23:42:37.586522
1370,494,2024-05-17,247,81,403,322,2025-07-23 23:42:37.587500
1371,1253,2024-05-29,241,164,466,302,2025-07-23 23:42:37.588476
1372,1264,2022-11-06,25,140,272,132,2025-07-23 23:42:37.589531
1373,9,2024-12-27,210,0,229,229,2025-07-23 23:42:37.590489
1374,724,2024-01-22,95,29,424,395,2025-07-23 23:42:37.591639
1375,776,2022-03-12,232,65,215,150,2025-07-23 23:42:37.592640
1376,695,2023-04-20,100,30,256,226,2025-07-23 23:42:37.593634
1377,1239,2024-03-12,162,58,217,159,2025-07-23 23:42:37.594618
1378,1137,2023-03-21,84,34,199,165,2025-07-23 23:42:37.595601
1379,142,2023-03-18,196,9,46,37,2025-07-23 23:42:37.596588
1380,995,2024-01-27,229,0,386,386,2025-07-23 23:42:37.597585
1381,859,2023-05-02,65,165,289,124,2025-07-23 23:42:37.598540
1382,1345,2022-01-24,90,123,183,60,2025-07-23 23:42:37.599505
1383,616,2022-03-25,189,189,203,14,2025-07-23 23:42:37.600464
1384,693,2024-06-19,113,229,287,58,2025-07-23 23:42:37.601453
1385,1444,2022-11-26,21,221,446,225,2025-07-23 23:42:37.602418
1386,1397,2024-06-11,150,0,57,57,2025-07-23 23:42:37.603370
1387,660,2024-08-09,16,27,309,282,2025-07-23 23:42:37.604317
1388,15,2022-09-30,9,27,106,79,2025-07-23 23:42:37.605283
1389,8,2024-10-02,104,142,164,22,2025-07-23 23:42:37.606231
1390,1399,2022-11-01,45,49,72,23,2025-07-23 23:42:37.607170
1391,818,2023-12-06,218,94,217,123,2025-07-23 23:42:37.608122
1392,318,2024-04-09,12,49,314,265,2025-07-23 23:42:37.609091
1393,1116,2022-05-16,94,184,489,305,2025-07-23 23:42:37.610024
1394,1382,2024-10-04,172,97,284,187,2025-07-23 23:42:37.610956
1395,850,2024-01-28,189,332,337,5,2025-07-23 23:42:37.611891
1396,1479,2024-07-07,188,184,201,17,2025-07-23 23:42:37.612841
1397,158,2022-07-03,144,23,63,40,2025-07-23 23:42:37.613802
1398,1350,2023-01-01,134,32,133,101,2025-07-23 23:42:37.614779
1399,623,2022-06-27,187,24,70,46,2025-07-23 23:42:37.615734
1400,312,2024-08-30,156,80,109,29,2025-07-23 23:42:37.616679
1401,896,2024-08-16,22,1,38,37,2025-07-23 23:42:37.617620
1402,977,2022-01-24,48,336,409,73,2025-07-23 23:42:37.618589
1403,850,2024-03-21,136,2,30,28,2025-07-23 23:42:37.619652
1404,576,2022-08-15,95,11,20,9,2025-07-23 23:42:37.620627
1405,363,2022-06-12,200,139,231,92,2025-07-23 23:42:37.621584
1406,747,2023-01-25,92,53,182,129,2025-07-23 23:42:37.622529
1407,1238,2024-03-27,64,46,85,39,2025-07-23 23:42:37.623479
1408,773,2022-03-17,83,59,327,268,2025-07-23 23:42:37.624438
1409,1478,2024-01-03,36,14,220,206,2025-07-23 23:42:37.625583
1410,1338,2023-09-20,27,22,94,72,2025-07-23 23:42:37.626685
1411,1171,2024-05-27,135,25,83,58,2025-07-23 23:42:37.627709
1412,280,2023-08-27,133,28,40,12,2025-07-23 23:42:37.628942
1413,1207,2024-11-07,72,24,325,301,2025-07-23 23:42:37.630010
1414,1306,2022-12-29,111,382,495,113,2025-07-23 23:42:37.631018
1415,1130,2023-08-27,28,348,355,7,2025-07-23 23:42:37.631989
1416,1389,2022-10-05,60,168,232,64,2025-07-23 23:42:37.632963
1417,573,2024-10-05,43,2,35,33,2025-07-23 23:42:37.633911
1418,297,2024-12-31,148,27,63,36,2025-07-23 23:42:37.635006
1419,1342,2022-10-18,68,11,95,84,2025-07-23 23:42:37.636190
1420,551,2023-10-28,204,6,43,37,2025-07-23 23:42:37.637337
1421,572,2023-07-13,237,173,464,291,2025-07-23 23:42:37.638386
1422,1067,2023-06-18,55,75,103,28,2025-07-23 23:42:37.639455
1423,1122,2022-05-21,188,203,238,35,2025-07-23 23:42:37.640558
1424,611,2024-01-03,168,6,40,34,2025-07-23 23:42:37.641601
1425,564,2023-03-20,44,70,336,266,2025-07-23 23:42:37.642645
1426,1493,2023-05-10,136,67,286,219,2025-07-23 23:42:37.643687
1427,1216,2023-06-07,152,111,343,232,2025-07-23 23:42:37.644722
1428,980,2024-12-28,72,10,263,253,2025-07-23 23:42:37.645837
1429,372,2023-01-02,23,293,333,40,2025-07-23 23:42:37.646900
1430,368,2023-02-25,84,74,190,116,2025-07-23 23:42:37.647968
1431,110,2023-01-12,212,340,379,39,2025-07-23 23:42:37.649043
1432,771,2023-08-02,19,188,334,146,2025-07-23 23:42:37.650077
1433,1092,2024-02-06,132,74,246,172,2025-07-23 23:42:37.651101
1434,340,2022-11-26,143,93,470,377,2025-07-23 23:42:37.652142
1435,465,2022-01-11,14,25,184,159,2025-07-23 23:42:37.653182
1436,1224,2024-06-10,71,127,325,198,2025-07-23 23:42:37.654205
1437,791,2024-04-13,47,205,395,190,2025-07-23 23:42:37.655223
1438,1029,2022-11-26,123,112,280,168,2025-07-23 23:42:37.656250
1439,486,2023-02-01,89,8,326,318,2025-07-23 23:42:37.657567
1440,955,2022-08-18,23,304,482,178,2025-07-23 23:42:37.658625
1441,96,2024-10-18,227,20,79,59,2025-07-23 23:42:37.659640
1442,719,2023-04-02,229,126,282,156,2025-07-23 23:42:37.660627
1443,460,2022-09-23,180,121,181,60,2025-07-23 23:42:37.661597
1444,112,2022-07-15,166,45,208,163,2025-07-23 23:42:37.662586
1445,237,2022-05-16,133,26,33,7,2025-07-23 23:42:37.663556
1446,451,2023-09-28,50,50,70,20,2025-07-23 23:42:37.664522
1447,1084,2024-05-10,147,121,149,28,2025-07-23 23:42:37.665488
1448,84,2022-06-19,181,270,399,129,2025-07-23 23:42:37.666454
1449,811,2023-09-06,65,52,246,194,2025-07-23 23:42:37.667625
1450,1055,2023-10-08,88,13,130,117,2025-07-23 23:42:37.668658
1451,1048,2022-09-10,180,104,111,7,2025-07-23 23:42:37.669686
1452,1362,2023-07-10,241,111,428,317,2025-07-23 23:42:37.670706
1453,273,2024-01-31,170,16,239,223,2025-07-23 23:42:37.671683
1454,855,2022-04-02,120,71,115,44,2025-07-23 23:42:37.672881
1455,522,2023-01-17,8,115,155,40,2025-07-23 23:42:37.673909
1456,859,2023-07-06,42,143,191,48,2025-07-23 23:42:37.674875
1457,255,2024-09-29,207,115,411,296,2025-07-23 23:42:37.675866
1458,554,2023-08-15,205,153,465,312,2025-07-23 23:42:37.676856
1459,803,2022-02-26,184,121,183,62,2025-07-23 23:42:37.677844
1460,871,2023-05-06,190,39,44,5,2025-07-23 23:42:37.678814
1461,1297,2024-03-01,182,23,150,127,2025-07-23 23:42:37.679783
1462,1183,2022-01-24,175,19,32,13,2025-07-23 23:42:37.680732
1463,392,2023-03-05,222,85,263,178,2025-07-23 23:42:37.681699
1464,1242,2024-09-11,149,171,278,107,2025-07-23 23:42:37.682644
1465,380,2023-02-14,197,85,269,184,2025-07-23 23:42:37.683610
1466,1177,2022-07-18,168,79,177,98,2025-07-23 23:42:37.684583
1467,292,2024-05-18,250,19,274,255,2025-07-23 23:42:37.685533
1468,1141,2022-10-13,78,4,15,11,2025-07-23 23:42:37.686473
1469,903,2023-04-06,42,22,380,358,2025-07-23 23:42:37.687437
1470,1420,2024-03-10,87,4,27,23,2025-07-23 23:42:37.688398
1471,1188,2024-07-23,114,403,491,88,2025-07-23 23:42:37.689366
1472,1083,2024-12-14,110,18,35,17,2025-07-23 23:42:37.690311
1473,114,2022-08-01,3,306,393,87,2025-07-23 23:42:37.691285
1474,488,2022-03-04,86,285,334,49,2025-07-23 23:42:37.692236
1475,1471,2023-07-04,32,29,133,104,2025-07-23 23:42:37.693186
1476,1378,2022-10-23,109,220,252,32,2025-07-23 23:42:37.694179
1477,38,2024-06-21,90,349,368,19,2025-07-23 23:42:37.695134
1478,459,2022-12-12,126,327,401,74,2025-07-23 23:42:37.696102
1479,218,2023-11-18,189,198,432,234,2025-07-23 23:42:37.697044
1480,901,2024-05-15,149,34,148,114,2025-07-23 23:42:37.698315
1481,436,2022-06-20,139,91,274,183,2025-07-23 23:42:37.699318
1482,826,2023-03-05,76,335,404,69,2025-07-23 23:42:37.700326
1483,1228,2022-05-26,142,133,298,165,2025-07-23 23:42:37.701514
1484,152,2024-03-16,95,131,207,76,2025-07-23 23:42:37.702517
1485,523,2023-12-09,215,60,155,95,2025-07-23 23:42:37.703492
1486,908,2022-06-27,33,251,317,66,2025-07-23 23:42:37.704648
1487,966,2022-05-01,77,235,365,130,2025-07-23 23:42:37.705715
1488,969,2022-01-27,106,17,246,229,2025-07-23 23:42:37.706713
1489,1150,2022-02-05,221,196,201,5,2025-07-23 23:42:37.707682
1490,654,2024-06-07,73,110,250,140,2025-07-23 23:42:37.709040
1491,1009,2023-09-21,226,293,356,63,2025-07-23 23:42:37.710181
1492,1280,2024-06-09,34,193,450,257,2025-07-23 23:42:37.711231
1493,939,2022-12-05,133,185,387,202,2025-07-23 23:42:37.712278
1494,1491,2024-07-08,138,279,344,65,2025-07-23 23:42:37.713336
1495,651,2024-04-17,77,238,327,89,2025-07-23 23:42:37.714434
1496,827,2022-11-22,78,122,174,52,2025-07-23 23:42:37.715489
1497,407,2024-04-29,214,37,78,41,2025-07-23 23:42:37.716536
1498,159,2022-10-18,139,428,484,56,2025-07-23 23:42:37.717558
1499,774,2023-03-31,200,122,131,9,2025-07-23 23:42:37.718584
1500,638,2023-07-25,35,54,159,105,2025-07-23 23:42:37.719645
1501,121,2024-11-22,221,47,92,45,2025-07-23 23:42:37.720846
1502,851,2022-05-13,144,239,298,59,2025-07-23 23:42:37.721953
1503,209,2022-06-29,35,236,267,31,2025-07-23 23:42:37.722941
1504,1383,2024-09-13,226,87,344,257,2025-07-23 23:42:37.723917
1505,1091,2023-07-25,7,220,256,36,2025-07-23 23:42:37.724966
1506,965,2024-01-30,217,40,79,39,2025-07-23 23:42:37.725951
1507,850,2022-01-26,23,88,104,16,2025-07-23 23:42:37.726901
1508,397,2022-12-16,194,57,217,160,2025-07-23 23:42:37.727885
1509,1174,2023-06-22,155,389,405,16,2025-07-23 23:42:37.728901
1510,736,2023-04-19,245,250,270,20,2025-07-23 23:42:37.729865
1511,372,2024-06-14,87,354,422,68,2025-07-23 23:42:37.730855
1512,31,2023-01-20,16,394,415,21,2025-07-23 23:42:37.731850
1513,146,2023-02-17,168,5,79,74,2025-07-23 23:42:37.732843
1514,169,2022-03-14,24,24,81,57,2025-07-23 23:42:37.733854
1515,398,2024-06-29,193,98,255,157,2025-07-23 23:42:37.734843
1516,1416,2023-12-25,141,120,135,15,2025-07-23 23:42:37.735984
1517,1389,2024-11-01,92,45,215,170,2025-07-23 23:42:37.737075
1518,241,2022-05-24,142,8,280,272,2025-07-23 23:42:37.738040
1519,447,2022-02-12,55,55,80,25,2025-07-23 23:42:37.739028
1520,1018,2022-06-03,171,76,369,293,2025-07-23 23:42:37.739961
1521,317,2023-11-19,229,162,374,212,2025-07-23 23:42:37.740929
1522,550,2022-04-14,11,142,337,195,2025-07-23 23:42:37.741907
1523,923,2022-10-16,211,165,272,107,2025-07-23 23:42:37.742866
1524,816,2024-04-08,199,69,228,159,2025-07-23 23:42:37.743853
1525,1399,2022-12-16,110,35,85,50,2025-07-23 23:42:37.745178
1526,1261,2024-03-01,30,342,362,20,2025-07-23 23:42:37.746183
1527,466,2022-11-05,2,69,454,385,2025-07-23 23:42:37.747165
1528,1488,2024-07-16,135,19,466,447,2025-07-23 23:42:37.748159
1529,798,2023-04-21,211,106,117,11,2025-07-23 23:42:37.749167
1530,266,2022-06-04,209,276,341,65,2025-07-23 23:42:37.750156
1531,585,2024-05-08,126,149,195,46,2025-07-23 23:42:37.751144
1532,1135,2024-12-24,177,24,210,186,2025-07-23 23:42:37.752120
1533,599,2023-06-10,66,184,230,46,2025-07-23 23:42:37.753093
1534,742,2022-04-15,153,24,38,14,2025-07-23 23:42:37.754073
1535,125,2024-05-11,207,35,43,8,2025-07-23 23:42:37.755034
1536,514,2022-06-28,58,380,490,110,2025-07-23 23:42:37.755968
1537,1206,2022-02-24,113,302,450,148,2025-07-23 23:42:37.756909
1538,1457,2022-09-17,154,11,21,10,2025-07-23 23:42:37.757850
1539,392,2024-09-27,120,288,337,49,2025-07-23 23:42:37.758865
1540,785,2022-08-26,169,159,293,134,2025-07-23 23:42:37.759842
1541,234,2024-07-30,27,49,107,58,2025-07-23 23:42:37.760803
1542,221,2023-04-11,46,35,145,110,2025-07-23 23:42:37.761748
1543,818,2024-08-14,182,102,391,289,2025-07-23 23:42:37.762732
1544,185,2024-06-23,149,18,80,62,2025-07-23 23:42:37.763681
1545,931,2022-12-12,37,144,166,22,2025-07-23 23:42:37.764633
1546,724,2023-04-04,108,51,496,445,2025-07-23 23:42:37.765612
1547,533,2022-05-18,7,53,267,214,2025-07-23 23:42:37.766590
1548,1165,2023-07-02,22,47,351,304,2025-07-23 23:42:37.767570
1549,450,2024-11-24,52,82,387,305,2025-07-23 23:42:37.768535
1550,1054,2024-08-13,188,99,333,234,2025-07-23 23:42:37.769503
1551,774,2024-10-21,233,8,45,37,2025-07-23 23:42:37.770463
1552,273,2024-05-21,113,279,384,105,2025-07-23 23:42:37.771428
1553,468,2022-03-17,109,27,281,254,2025-07-23 23:42:37.772387
1554,613,2023-01-12,131,58,112,54,2025-07-23 23:42:37.773463
1555,710,2024-10-24,37,254,402,148,2025-07-23 23:42:37.774441
1556,343,2022-05-17,201,21,100,79,2025-07-23 23:42:37.775447
1557,953,2024-07-12,209,164,467,303,2025-07-23 23:42:37.776420
1558,582,2023-07-14,150,154,248,94,2025-07-23 23:42:37.777373
1559,70,2023-06-16,243,149,189,40,2025-07-23 23:42:37.778325
1560,992,2022-12-19,72,148,439,291,2025-07-23 23:42:37.779277
1561,1077,2024-07-29,155,178,256,78,2025-07-23 23:42:37.780222
1562,171,2023-06-16,53,156,203,47,2025-07-23 23:42:37.781186
1563,1158,2022-10-03,21,18,25,7,2025-07-23 23:42:37.782152
1564,1037,2024-02-14,228,179,288,109,2025-07-23 23:42:37.783122
1565,196,2024-03-03,3,3,38,35,2025-07-23 23:42:37.784072
1566,908,2023-02-04,210,197,397,200,2025-07-23 23:42:37.785016
1567,47,2024-07-29,11,23,173,150,2025-07-23 23:42:37.785967
1568,297,2022-10-29,107,329,334,5,2025-07-23 23:42:37.786882
1569,1259,2024-09-23,159,84,209,125,2025-07-23 23:42:37.787851
1570,915,2024-07-07,99,379,470,91,2025-07-23 23:42:37.788839
1571,1384,2023-08-22,170,17,194,177,2025-07-23 23:42:37.789804
1572,415,2022-10-10,168,147,371,224,2025-07-23 23:42:37.790743
1573,887,2023-05-01,51,146,234,88,2025-07-23 23:42:37.791698
1574,988,2023-03-04,61,68,496,428,2025-07-23 23:42:37.792647
1575,1310,2023-04-15,20,120,403,283,2025-07-23 23:42:37.793614
1576,979,2024-04-28,117,16,390,374,2025-07-23 23:42:37.794588
1577,338,2023-07-06,231,258,387,129,2025-07-23 23:42:37.795548
1578,439,2024-03-15,153,313,436,123,2025-07-23 23:42:37.796495
1579,17,2023-11-13,8,126,234,108,2025-07-23 23:42:37.797461
1580,520,2023-07-23,110,350,432,82,2025-07-23 23:42:37.798433
1581,523,2024-12-13,149,164,376,212,2025-07-23 23:42:37.799416
1582,989,2022-07-03,107,181,192,11,2025-07-23 23:42:37.800369
1583,753,2023-04-27,246,9,403,394,2025-07-23 23:42:37.801400
1584,999,2024-09-11,223,8,364,356,2025-07-23 23:42:37.802577
1585,945,2022-02-20,112,46,327,281,2025-07-23 23:42:37.803646
1586,949,2024-06-02,125,42,307,265,2025-07-23 23:42:37.804887
1587,936,2022-12-08,80,51,376,325,2025-07-23 23:42:37.805976
1588,725,2023-02-19,46,324,381,57,2025-07-23 23:42:37.806927
1589,102,2023-05-01,231,211,336,125,2025-07-23 23:42:37.808159
1590,87,2022-12-13,8,230,330,100,2025-07-23 23:42:37.808870
1591,1357,2022-09-20,173,36,256,220,2025-07-23 23:42:37.809510
1592,761,2023-03-22,61,25,243,218,2025-07-23 23:42:37.810226
1593,1225,2022-10-07,104,129,397,268,2025-07-23 23:42:37.810933
1594,143,2024-04-04,167,78,206,128,2025-07-23 23:42:37.811574
1595,1248,2022-12-07,58,271,475,204,2025-07-23 23:42:37.812277
1596,508,2022-07-28,138,59,299,240,2025-07-23 23:42:37.812945
1597,887,2022-01-18,114,72,484,412,2025-07-23 23:42:37.813604
1598,863,2023-09-22,192,323,388,65,2025-07-23 23:42:37.814317
1599,657,2023-12-29,210,111,442,331,2025-07-23 23:42:37.815013
1600,429,2022-02-02,100,63,99,36,2025-07-23 23:42:37.815652
1601,774,2022-12-31,225,4,17,13,2025-07-23 23:42:37.816309
1602,801,2022-07-19,209,258,325,67,2025-07-23 23:42:37.816944
1603,874,2024-07-20,39,182,190,8,2025-07-23 23:42:37.817560
1604,960,2023-11-27,130,262,273,11,2025-07-23 23:42:37.818208
1605,203,2022-06-26,4,18,206,188,2025-07-23 23:42:37.818837
1606,567,2022-12-16,42,154,448,294,2025-07-23 23:42:37.819446
1607,19,2022-03-20,18,54,348,294,2025-07-23 23:42:37.820106
1608,490,2023-03-21,18,96,156,60,2025-07-23 23:42:37.820700
1609,1441,2022-05-03,14,87,306,219,2025-07-23 23:42:37.821400
1610,371,2023-12-24,19,150,285,135,2025-07-23 23:42:37.822037
1611,81,2023-07-01,47,104,112,8,2025-07-23 23:42:37.822635
1612,633,2024-05-20,83,20,38,18,2025-07-23 23:42:37.823283
1613,1441,2022-08-08,102,56,95,39,2025-07-23 23:42:37.823908
1614,204,2024-04-29,191,154,446,292,2025-07-23 23:42:37.824506
1615,1368,2022-09-10,250,20,101,81,2025-07-23 23:42:37.825167
1616,550,2023-03-30,110,353,497,144,2025-07-23 23:42:37.825782
1617,1331,2023-03-21,31,0,290,290,2025-07-23 23:42:37.826411
1618,958,2023-07-01,82,98,158,60,2025-07-23 23:42:37.827036
1619,655,2024-06-22,157,172,178,6,2025-07-23 23:42:37.827621
1620,592,2023-08-11,68,403,438,35,2025-07-23 23:42:37.828245
1621,942,2023-12-31,243,45,164,119,2025-07-23 23:42:37.828985
1622,562,2024-10-24,24,280,375,95,2025-07-23 23:42:37.829624
1623,239,2023-10-01,128,69,248,179,2025-07-23 23:42:37.830255
1624,146,2024-09-13,243,172,213,41,2025-07-23 23:42:37.830886
1625,243,2022-08-30,83,463,496,33,2025-07-23 23:42:37.831479
1626,951,2022-04-01,174,28,96,68,2025-07-23 23:42:37.832106
1627,184,2022-06-24,162,246,337,91,2025-07-23 23:42:37.832688
1628,696,2024-06-26,151,104,220,116,2025-07-23 23:42:37.833319
1629,672,2022-02-02,67,25,45,20,2025-07-23 23:42:37.833966
1630,222,2023-03-23,12,229,237,8,2025-07-23 23:42:37.834585
1631,319,2024-07-07,182,9,374,365,2025-07-23 23:42:37.835308
1632,1230,2024-05-01,2,213,279,66,2025-07-23 23:42:37.836063
1633,1152,2022-07-17,40,98,470,372,2025-07-23 23:42:37.836658
1634,409,2024-12-16,10,161,399,238,2025-07-23 23:42:37.837290
1635,335,2024-01-09,148,53,123,70,2025-07-23 23:42:37.837928
1636,470,2023-01-19,70,3,80,77,2025-07-23 23:42:37.838545
1637,1165,2023-08-06,171,185,233,48,2025-07-23 23:42:37.839197
1638,1103,2022-03-22,76,350,386,36,2025-07-23 23:42:37.839805
1639,382,2022-02-09,196,67,398,331,2025-07-23 23:42:37.840403
1640,404,2022-12-03,65,33,131,98,2025-07-23 23:42:37.841036
1641,1098,2024-10-07,148,75,87,12,2025-07-23 23:42:37.841623
1642,1439,2022-07-18,240,163,212,49,2025-07-23 23:42:37.842273
1643,865,2022-07-01,46,461,490,29,2025-07-23 23:42:37.842891
1644,152,2023-06-20,17,122,241,119,2025-07-23 23:42:37.843487
1645,775,2024-09-06,96,56,339,283,2025-07-23 23:42:37.844117
1646,1472,2023-11-24,203,160,179,19,2025-07-23 23:42:37.844718
1647,1338,2023-04-05,49,101,130,29,2025-07-23 23:42:37.845411
1648,164,2024-02-19,204,178,371,193,2025-07-23 23:42:37.846053
1649,456,2024-02-06,51,106,301,195,2025-07-23 23:42:37.846645
1650,82,2023-10-20,52,394,427,33,2025-07-23 23:42:37.847276
1651,1193,2023-05-17,219,140,317,177,2025-07-23 23:42:37.847903
1652,234,2024-04-24,219,122,145,23,2025-07-23 23:42:37.848513
1653,1070,2023-01-27,210,30,51,21,2025-07-23 23:42:37.849177
1654,754,2024-07-08,59,43,71,28,2025-07-23 23:42:37.849801
1655,631,2022-10-03,22,308,408,100,2025-07-23 23:42:37.850403
1656,469,2024-12-23,16,46,60,14,2025-07-23 23:42:37.851059
1657,268,2024-04-19,168,32,228,196,2025-07-23 23:42:37.851645
1658,369,2023-06-22,138,33,46,13,2025-07-23 23:42:37.852299
1659,572,2024-12-07,118,53,82,29,2025-07-23 23:42:37.852927
1660,2,2023-11-18,140,305,320,15,2025-07-23 23:42:37.853521
1661,762,2023-01-01,113,165,378,213,2025-07-23 23:42:37.854150
1662,160,2023-01-07,58,128,363,235,2025-07-23 23:42:37.854781
1663,1366,2023-11-19,230,42,88,46,2025-07-23 23:42:37.855387
1664,468,2022-09-04,143,95,414,319,2025-07-23 23:42:37.856030
1665,725,2024-03-05,175,48,212,164,2025-07-23 23:42:37.856615
1666,1181,2024-08-23,201,216,385,169,2025-07-23 23:42:37.857251
1667,577,2024-05-14,168,32,77,45,2025-07-23 23:42:37.857859
1668,656,2023-12-06,170,173,290,117,2025-07-23 23:42:37.858437
1669,411,2024-08-12,1,33,388,355,2025-07-23 23:42:37.859049
1670,115,2022-12-08,21,26,63,37,2025-07-23 23:42:37.859673
1671,354,2023-12-05,8,30,222,192,2025-07-23 23:42:37.860443
1672,1185,2023-07-15,161,42,223,181,2025-07-23 23:42:37.861085
1673,460,2023-09-09,32,72,237,165,2025-07-23 23:42:37.861686
1674,808,2022-05-07,241,65,100,35,2025-07-23 23:42:37.862328
1675,1184,2023-01-10,204,125,260,135,2025-07-23 23:42:37.862969
1676,1448,2023-05-01,115,239,364,125,2025-07-23 23:42:37.863582
1677,1448,2022-06-04,109,249,458,209,2025-07-23 23:42:37.864226
1678,795,2022-03-05,76,379,401,22,2025-07-23 23:42:37.864852
1679,207,2023-10-03,132,154,236,82,2025-07-23 23:42:37.865453
1680,994,2024-12-04,57,46,76,30,2025-07-23 23:42:37.866169
1681,1396,2023-03-19,120,12,88,76,2025-07-23 23:42:37.866788
1682,520,2024-11-03,188,204,268,64,2025-07-23 23:42:37.867398
1683,1498,2023-09-29,81,1,19,18,2025-07-23 23:42:37.868023
1684,1151,2022-12-28,175,20,393,373,2025-07-23 23:42:37.868604
1685,1383,2022-05-08,112,213,278,65,2025-07-23 23:42:37.869270
1686,1494,2023-11-24,100,69,229,160,2025-07-23 23:42:37.869901
1687,1316,2022-05-30,74,13,250,237,2025-07-23 23:42:37.870507
1688,175,2022-02-22,113,271,318,47,2025-07-23 23:42:37.871133
1689,511,2024-11-01,96,39,67,28,2025-07-23 23:42:37.871732
1690,392,2022-01-31,130,103,111,8,2025-07-23 23:42:37.872357
1691,1081,2023-10-03,191,69,221,152,2025-07-23 23:42:37.872981
1692,1029,2023-12-03,213,326,379,53,2025-07-23 23:42:37.873574
1693,306,2023-12-14,78,168,412,244,2025-07-23 23:42:37.874205
1694,1197,2024-11-26,163,14,74,60,2025-07-23 23:42:37.874815
1695,1117,2024-07-20,38,0,51,51,2025-07-23 23:42:37.875429
1696,515,2023-06-15,93,203,463,260,2025-07-23 23:42:37.876126
1697,337,2023-12-14,126,65,337,272,2025-07-23 23:42:37.876744
1698,1095,2023-04-13,222,54,107,53,2025-07-23 23:42:37.877377
1699,459,2024-05-08,91,14,321,307,2025-07-23 23:42:37.878068
1700,1309,2022-03-25,152,134,250,116,2025-07-23 23:42:37.878740
1701,974,2022-02-26,187,228,366,138,2025-07-23 23:42:37.879507
1702,79,2023-02-04,94,343,357,14,2025-07-23 23:42:37.880198
1703,449,2022-05-10,10,91,132,41,2025-07-23 23:42:37.880851
1704,252,2022-04-07,3,163,308,145,2025-07-23 23:42:37.881466
1705,828,2024-08-26,91,42,90,48,2025-07-23 23:42:37.882095
1706,494,2023-10-19,35,114,139,25,2025-07-23 23:42:37.882683
1707,352,2022-05-13,125,57,186,129,2025-07-23 23:42:37.883318
1708,843,2022-03-24,81,29,411,382,2025-07-23 23:42:37.883941
1709,644,2023-12-03,144,213,228,15,2025-07-23 23:42:37.884538
1710,38,2022-12-27,169,391,403,12,2025-07-23 23:42:37.885165
1711,516,2024-04-09,113,39,152,113,2025-07-23 23:42:37.885751
1712,268,2022-05-28,16,347,353,6,2025-07-23 23:42:37.886408
1713,1019,2023-12-31,54,9,133,124,2025-07-23 23:42:37.887039
1714,30,2022-02-03,16,201,472,271,2025-07-23 23:42:37.887622
1715,367,2022-05-05,92,393,475,82,2025-07-23 23:42:37.888248
1716,1370,2023-03-05,51,287,397,110,2025-07-23 23:42:37.888908
1717,229,2022-01-14,107,45,139,94,2025-07-23 23:42:37.889581
1718,44,2024-08-18,199,34,129,95,2025-07-23 23:42:37.890236
1719,1073,2024-07-19,100,9,22,13,2025-07-23 23:42:37.890858
1720,920,2023-07-17,8,226,260,34,2025-07-23 23:42:37.891454
1721,167,2024-07-20,155,117,182,65,2025-07-23 23:42:37.892077
1722,1118,2023-12-02,156,222,426,204,2025-07-23 23:42:37.892660
1723,80,2023-09-02,93,111,318,207,2025-07-23 23:42:37.893322
1724,462,2022-02-14,117,3,32,29,2025-07-23 23:42:37.893970
1725,618,2022-08-16,57,2,286,284,2025-07-23 23:42:37.894559
1726,310,2024-10-02,234,380,462,82,2025-07-23 23:42:37.895181
1727,1208,2023-11-27,10,314,439,125,2025-07-23 23:42:37.895784
1728,211,2022-05-01,35,82,156,74,2025-07-23 23:42:37.896386
1729,917,2024-09-04,139,52,455,403,2025-07-23 23:42:37.897096
1730,21,2022-12-19,30,232,280,48,2025-07-23 23:42:37.897688
1731,1189,2023-09-20,202,142,210,68,2025-07-23 23:42:37.898313
1732,1325,2023-02-09,58,19,87,68,2025-07-23 23:42:37.898937
1733,92,2022-09-10,162,358,367,9,2025-07-23 23:42:37.899539
1734,615,2024-12-07,98,0,182,182,2025-07-23 23:42:37.900162
1735,1040,2022-09-17,64,0,148,148,2025-07-23 23:42:37.900740
1736,375,2022-09-24,40,324,473,149,2025-07-23 23:42:37.901362
1737,163,2022-04-04,244,64,83,19,2025-07-23 23:42:37.902225
1738,1231,2024-02-11,84,13,99,86,2025-07-23 23:42:37.903221
1739,189,2022-03-28,134,28,341,313,2025-07-23 23:42:37.904197
1740,1288,2022-11-16,35,257,374,117,2025-07-23 23:42:37.905172
1741,1219,2024-08-16,110,90,306,216,2025-07-23 23:42:37.906146
1742,238,2022-05-26,60,221,266,45,2025-07-23 23:42:37.907113
1743,1047,2023-04-28,34,134,237,103,2025-07-23 23:42:37.908065
1744,509,2024-11-30,47,36,211,175,2025-07-23 23:42:37.909043
1745,841,2022-11-13,107,31,186,155,2025-07-23 23:42:37.910012
1746,1341,2023-01-28,162,178,290,112,2025-07-23 23:42:37.910964
1747,149,2022-07-01,34,112,276,164,2025-07-23 23:42:37.911895
1748,729,2022-09-15,199,4,61,57,2025-07-23 23:42:37.912858
1749,80,2023-06-06,86,207,404,197,2025-07-23 23:42:37.914367
1750,1407,2022-03-31,79,105,412,307,2025-07-23 23:42:37.915519
1751,228,2024-03-29,161,55,85,30,2025-07-23 23:42:37.916589
1752,1257,2022-11-28,76,204,275,71,2025-07-23 23:42:37.917672
1753,1427,2024-01-24,21,7,438,431,2025-07-23 23:42:37.918795
1754,688,2024-08-19,27,11,218,207,2025-07-23 23:42:37.919923
1755,443,2022-04-20,242,98,397,299,2025-07-23 23:42:37.921032
1756,143,2022-03-05,53,36,297,261,2025-07-23 23:42:37.922094
1757,661,2024-08-23,156,107,277,170,2025-07-23 23:42:37.923138
1758,1445,2022-01-30,43,44,145,101,2025-07-23 23:42:37.924221
1759,972,2024-02-07,45,416,453,37,2025-07-23 23:42:37.925256
1760,720,2023-10-07,12,18,40,22,2025-07-23 23:42:37.926506
1761,173,2023-03-09,201,60,107,47,2025-07-23 23:42:37.927672
1762,553,2022-06-22,13,76,176,100,2025-07-23 23:42:37.928676
1763,300,2024-11-01,32,53,96,43,2025-07-23 23:42:37.929615
1764,1218,2022-08-02,228,63,146,83,2025-07-23 23:42:37.930604
1765,713,2023-03-27,110,7,20,13,2025-07-23 23:42:37.931579
1766,645,2022-12-11,210,51,126,75,2025-07-23 23:42:37.932553
1767,1242,2023-07-27,225,434,493,59,2025-07-23 23:42:37.933519
1768,912,2022-07-06,70,332,491,159,2025-07-23 23:42:37.934495
1769,84,2024-07-30,213,0,71,71,2025-07-23 23:42:37.935751
1770,219,2024-07-28,200,130,448,318,2025-07-23 23:42:37.936954
1771,878,2024-04-17,207,33,259,226,2025-07-23 23:42:37.938021
1772,60,2022-07-20,223,336,364,28,2025-07-23 23:42:37.938971
1773,696,2024-05-06,4,130,157,27,2025-07-23 23:42:37.940169
1774,746,2024-09-03,87,42,112,70,2025-07-23 23:42:37.941247
1775,1228,2022-07-01,5,126,231,105,2025-07-23 23:42:37.942223
1776,1282,2022-05-30,26,1,44,43,2025-07-23 23:42:37.943204
1777,1150,2024-03-12,55,22,92,70,2025-07-23 23:42:37.944173
1778,1398,2023-02-14,2,20,67,47,2025-07-23 23:42:37.945258
1779,620,2024-08-07,247,79,124,45,2025-07-23 23:42:37.946328
1780,1416,2024-10-15,227,227,483,256,2025-07-23 23:42:37.947309
1781,837,2024-10-06,93,299,323,24,2025-07-23 23:42:37.948301
1782,1011,2023-05-30,213,118,162,44,2025-07-23 23:42:37.949314
1783,91,2024-07-26,150,301,384,83,2025-07-23 23:42:37.950296
1784,540,2023-11-22,110,5,452,447,2025-07-23 23:42:37.951270
1785,1373,2024-01-08,135,12,120,108,2025-07-23 23:42:37.952245
1786,229,2022-11-11,62,158,393,235,2025-07-23 23:42:37.953206
1787,1321,2024-06-01,86,294,417,123,2025-07-23 23:42:37.954177
1788,1094,2024-07-06,216,2,124,122,2025-07-23 23:42:37.955161
1789,1441,2024-01-24,85,7,455,448,2025-07-23 23:42:37.956150
1790,691,2023-02-08,223,207,472,265,2025-07-23 23:42:37.957295
1791,1275,2022-10-21,192,135,270,135,2025-07-23 23:42:37.958538
1792,981,2022-02-22,109,234,318,84,2025-07-23 23:42:37.959714
1793,195,2022-05-02,16,32,97,65,2025-07-23 23:42:37.960873
1794,472,2023-09-12,128,48,303,255,2025-07-23 23:42:37.962034
1795,821,2022-03-30,133,316,489,173,2025-07-23 23:42:37.963088
1796,1039,2024-01-14,127,23,33,10,2025-07-23 23:42:37.964233
1797,203,2023-08-20,187,242,253,11,2025-07-23 23:42:37.965265
1798,1223,2023-10-09,14,196,222,26,2025-07-23 23:42:37.966340
1799,702,2023-12-24,219,20,487,467,2025-07-23 23:42:37.967376
1800,354,2024-12-27,193,123,246,123,2025-07-23 23:42:37.968418
1801,378,2022-01-18,136,147,214,67,2025-07-23 23:42:37.969499
1802,802,2024-01-02,107,21,48,27,2025-07-23 23:42:37.970548
1803,600,2022-09-15,159,78,102,24,2025-07-23 23:42:37.971595
1804,629,2024-03-24,14,7,40,33,2025-07-23 23:42:37.972677
1805,566,2024-07-23,63,330,362,32,2025-07-23 23:42:37.973738
1806,437,2023-11-14,35,25,307,282,2025-07-23 23:42:37.974843
1807,1110,2023-01-01,42,13,241,228,2025-07-23 23:42:37.975907
1808,1225,2024-09-02,181,193,308,115,2025-07-23 23:42:37.977021
1809,523,2023-08-14,41,202,261,59,2025-07-23 23:42:37.978050
1810,475,2024-05-24,114,144,222,78,2025-07-23 23:42:37.979051
1811,374,2022-03-18,131,243,260,17,2025-07-23 23:42:37.980103
1812,1047,2023-08-15,207,106,170,64,2025-07-23 23:42:37.981177
1813,1474,2022-05-01,66,40,237,197,2025-07-23 23:42:37.982225
1814,1424,2024-07-31,223,21,176,155,2025-07-23 23:42:37.983240
1815,1477,2024-07-19,233,314,443,129,2025-07-23 23:42:37.984255
1816,1479,2023-11-19,84,323,391,68,2025-07-23 23:42:37.985272
1817,1133,2024-08-22,62,56,96,40,2025-07-23 23:42:37.986307
1818,1114,2024-09-12,95,67,104,37,2025-07-23 23:42:37.987394
1819,1130,2023-04-09,213,52,333,281,2025-07-23 23:42:37.988542
1820,203,2023-07-17,230,72,125,53,2025-07-23 23:42:37.989675
1821,623,2022-01-30,217,117,228,111,2025-07-23 23:42:37.990720
1822,732,2022-05-29,236,118,304,186,2025-07-23 23:42:37.991852
1823,170,2023-08-08,29,293,299,6,2025-07-23 23:42:37.993068
1824,1291,2022-12-08,161,129,192,63,2025-07-23 23:42:37.994294
1825,552,2024-03-15,142,109,146,37,2025-07-23 23:42:37.995477
1826,498,2022-07-09,72,196,432,236,2025-07-23 23:42:37.996684
1827,1101,2022-06-22,72,8,316,308,2025-07-23 23:42:37.997909
1828,804,2022-08-25,162,15,171,156,2025-07-23 23:42:37.999117
1829,422,2022-03-14,171,236,497,261,2025-07-23 23:42:38.000284
1830,1435,2023-03-11,148,71,273,202,2025-07-23 23:42:38.001674
1831,134,2022-01-09,38,47,136,89,2025-07-23 23:42:38.002973
1832,244,2024-04-26,80,3,238,235,2025-07-23 23:42:38.004075
1833,841,2022-03-21,36,148,373,225,2025-07-23 23:42:38.005169
1834,1134,2023-07-07,141,282,315,33,2025-07-23 23:42:38.006260
1835,507,2024-06-28,243,35,49,14,2025-07-23 23:42:38.007514
1836,1358,2023-02-28,250,77,145,68,2025-07-23 23:42:38.008966
1837,1125,2024-04-19,240,51,304,253,2025-07-23 23:42:38.010221
1838,394,2023-08-16,125,93,491,398,2025-07-23 23:42:38.011358
1839,592,2023-01-24,204,175,265,90,2025-07-23 23:42:38.012462
1840,123,2022-02-08,56,25,299,274,2025-07-23 23:42:38.013559
1841,1026,2022-03-10,126,282,375,93,2025-07-23 23:42:38.014657
1842,193,2022-08-13,133,160,224,64,2025-07-23 23:42:38.015805
1843,1200,2023-04-06,92,151,180,29,2025-07-23 23:42:38.016957
1844,434,2023-09-06,235,21,73,52,2025-07-23 23:42:38.018163
1845,295,2024-06-08,166,27,168,141,2025-07-23 23:42:38.019356
1846,388,2024-08-11,108,24,119,95,2025-07-23 23:42:38.020812
1847,520,2024-05-21,37,103,324,221,2025-07-23 23:42:38.022082
1848,776,2022-12-04,101,19,40,21,2025-07-23 23:42:38.023319
1849,475,2024-11-06,157,174,384,210,2025-07-23 23:42:38.024487
1850,611,2024-09-24,101,38,180,142,2025-07-23 23:42:38.025649
1851,487,2023-09-25,225,360,441,81,2025-07-23 23:42:38.026864
1852,896,2023-08-02,153,190,195,5,2025-07-23 23:42:38.028038
1853,1408,2022-12-08,19,152,158,6,2025-07-23 23:42:38.029297
1854,1379,2024-02-14,198,30,174,144,2025-07-23 23:42:38.030422
1855,407,2022-01-11,110,155,164,9,2025-07-23 23:42:38.031493
1856,258,2022-06-23,3,53,61,8,2025-07-23 23:42:38.032440
1857,181,2022-12-23,43,19,112,93,2025-07-23 23:42:38.033182
1858,498,2023-01-27,15,253,493,240,2025-07-23 23:42:38.033889
1859,779,2022-12-16,41,53,72,19,2025-07-23 23:42:38.034540
1860,1457,2022-09-13,224,75,401,326,2025-07-23 23:42:38.035248
1861,605,2023-05-11,171,3,410,407,2025-07-23 23:42:38.035951
1862,1428,2022-10-10,60,4,23,19,2025-07-23 23:42:38.036605
1863,3,2023-06-23,13,151,243,92,2025-07-23 23:42:38.037322
1864,696,2023-10-06,51,333,369,36,2025-07-23 23:42:38.038024
1865,101,2023-08-23,209,56,92,36,2025-07-23 23:42:38.038635
1866,1225,2024-02-03,176,264,302,38,2025-07-23 23:42:38.039329
1867,99,2024-10-16,117,94,352,258,2025-07-23 23:42:38.040024
1868,57,2024-01-06,122,66,181,115,2025-07-23 23:42:38.040678
1869,449,2023-07-07,202,116,158,42,2025-07-23 23:42:38.041363
1870,772,2022-01-23,192,391,427,36,2025-07-23 23:42:38.042041
1871,1336,2022-11-10,169,2,36,34,2025-07-23 23:42:38.042659
1872,984,2022-08-05,4,185,476,291,2025-07-23 23:42:38.043355
1873,675,2022-07-08,133,178,186,8,2025-07-23 23:42:38.044029
1874,807,2022-07-15,134,155,187,32,2025-07-23 23:42:38.044644
1875,573,2023-03-08,197,351,396,45,2025-07-23 23:42:38.045303
1876,262,2023-04-03,77,237,397,160,2025-07-23 23:42:38.045959
1877,1350,2022-04-22,87,216,236,20,2025-07-23 23:42:38.046608
1878,875,2022-07-23,153,356,363,7,2025-07-23 23:42:38.047489
1879,609,2022-10-03,206,133,339,206,2025-07-23 23:42:38.048317
1880,214,2022-05-17,180,57,297,240,2025-07-23 23:42:38.049043
1881,387,2024-04-05,59,10,25,15,2025-07-23 23:42:38.049680
1882,442,2024-06-19,119,311,423,112,2025-07-23 23:42:38.050370
1883,651,2024-05-10,250,256,265,9,2025-07-23 23:42:38.051046
1884,1000,2023-12-12,244,248,337,89,2025-07-23 23:42:38.051661
1885,434,2023-10-28,68,141,267,126,2025-07-23 23:42:38.052331
1886,841,2024-08-19,146,34,117,83,2025-07-23 23:42:38.053001
1887,1232,2023-08-08,193,73,177,104,2025-07-23 23:42:38.053645
1888,294,2022-08-20,122,61,315,254,2025-07-23 23:42:38.054595
1889,652,2024-11-20,43,131,167,36,2025-07-23 23:42:38.055399
1890,728,2022-04-27,245,41,355,314,2025-07-23 23:42:38.056224
1891,1128,2024-04-20,223,29,167,138,2025-07-23 23:42:38.056979
1892,350,2022-11-10,220,116,468,352,2025-07-23 23:42:38.057692
1893,1100,2023-03-22,93,55,225,170,2025-07-23 23:42:38.058432
1894,54,2023-11-19,146,209,269,60,2025-07-23 23:42:38.059168
1895,93,2022-10-23,216,154,176,22,2025-07-23 23:42:38.059903
1896,407,2023-03-31,182,187,223,36,2025-07-23 23:42:38.060620
1897,45,2024-10-08,143,25,387,362,2025-07-23 23:42:38.061348
1898,501,2022-06-20,136,4,34,30,2025-07-23 23:42:38.062093
1899,93,2024-05-18,51,18,34,16,2025-07-23 23:42:38.062790
1900,1383,2024-03-02,117,102,397,295,2025-07-23 23:42:38.063493
1901,1259,2022-11-17,15,97,413,316,2025-07-23 23:42:38.064224
1902,233,2022-07-05,152,257,392,135,2025-07-23 23:42:38.064947
1903,1418,2024-04-06,15,5,81,76,2025-07-23 23:42:38.065617
1904,1348,2024-10-18,226,17,313,296,2025-07-23 23:42:38.066328
1905,5,2024-06-27,6,10,345,335,2025-07-23 23:42:38.067037
1906,785,2022-11-21,112,25,53,28,2025-07-23 23:42:38.067707
1907,103,2022-06-23,87,20,49,29,2025-07-23 23:42:38.068436
1908,432,2024-07-09,5,347,416,69,2025-07-23 23:42:38.069247
1909,118,2023-01-16,101,268,274,6,2025-07-23 23:42:38.069966
1910,762,2023-02-15,150,285,421,136,2025-07-23 23:42:38.070632
1911,1142,2022-01-27,239,370,422,52,2025-07-23 23:42:38.071339
1912,899,2023-09-01,118,8,296,288,2025-07-23 23:42:38.072040
1913,1283,2023-03-24,173,75,89,14,2025-07-23 23:42:38.072698
1914,895,2024-03-25,5,3,341,338,2025-07-23 23:42:38.073445
1915,242,2023-09-01,211,12,425,413,2025-07-23 23:42:38.074156
1916,288,2022-10-01,161,24,57,33,2025-07-23 23:42:38.074842
1917,61,2024-02-20,51,16,28,12,2025-07-23 23:42:38.075546
1918,1085,2022-11-04,157,106,292,186,2025-07-23 23:42:38.076252
1919,1390,2023-12-18,102,109,210,101,2025-07-23 23:42:38.076965
1920,427,2022-01-24,81,372,410,38,2025-07-23 23:42:38.077635
1921,250,2022-01-07,50,24,29,5,2025-07-23 23:42:38.078342
1922,1108,2024-05-05,178,25,108,83,2025-07-23 23:42:38.079049
1923,162,2023-03-25,115,21,37,16,2025-07-23 23:42:38.079720
1924,340,2024-01-30,229,94,250,156,2025-07-23 23:42:38.080433
1925,455,2022-05-20,194,28,53,25,2025-07-23 23:42:38.081149
1926,1169,2022-03-13,67,111,184,73,2025-07-23 23:42:38.081846
1927,310,2022-07-14,196,300,374,74,2025-07-23 23:42:38.082534
1928,1082,2024-06-08,21,171,340,169,2025-07-23 23:42:38.083262
1929,481,2022-03-28,145,17,368,351,2025-07-23 23:42:38.084120
1930,212,2024-01-01,50,367,421,54,2025-07-23 23:42:38.084925
1931,280,2023-12-06,38,42,239,197,2025-07-23 23:42:38.085671
1932,470,2022-02-14,13,91,227,136,2025-07-23 23:42:38.086495
1933,1297,2022-08-13,6,408,477,69,2025-07-23 23:42:38.087308
1934,1350,2022-10-29,2,150,169,19,2025-07-23 23:42:38.088066
1935,790,2022-10-13,57,19,109,90,2025-07-23 23:42:38.088811
1936,1039,2023-06-28,35,78,388,310,2025-07-23 23:42:38.089531
1937,12,2024-12-30,174,7,242,235,2025-07-23 23:42:38.090306
1938,581,2023-07-08,168,197,327,130,2025-07-23 23:42:38.091058
1939,784,2024-01-04,43,16,483,467,2025-07-23 23:42:38.091731
1940,372,2023-05-30,142,120,222,102,2025-07-23 23:42:38.092486
1941,365,2022-01-28,128,28,456,428,2025-07-23 23:42:38.093244
1942,303,2022-07-11,32,274,482,208,2025-07-23 23:42:38.094023
1943,680,2024-05-03,166,11,74,63,2025-07-23 23:42:38.094698
1944,102,2024-12-11,19,259,355,96,2025-07-23 23:42:38.095500
1945,694,2022-02-23,225,230,276,46,2025-07-23 23:42:38.096218
1946,762,2022-08-20,158,220,478,258,2025-07-23 23:42:38.096936
1947,719,2023-10-03,166,12,17,5,2025-07-23 23:42:38.097612
1948,717,2022-11-26,21,90,206,116,2025-07-23 23:42:38.098326
1949,355,2023-09-01,168,37,43,6,2025-07-23 23:42:38.099025
1950,1166,2022-11-17,236,232,444,212,2025-07-23 23:42:38.099702
1951,1255,2022-05-10,223,44,180,136,2025-07-23 23:42:38.100449
1952,1469,2024-03-23,142,130,484,354,2025-07-23 23:42:38.101494
1953,468,2023-08-23,172,132,191,59,2025-07-23 23:42:38.102550
1954,978,2024-09-29,31,22,146,124,2025-07-23 23:42:38.103425
1955,1459,2024-10-11,200,72,158,86,2025-07-23 23:42:38.104262
1956,21,2022-06-16,98,8,68,60,2025-07-23 23:42:38.105122
1957,319,2023-10-15,75,9,39,30,2025-07-23 23:42:38.105927
1958,700,2024-04-23,148,70,79,9,2025-07-23 23:42:38.106686
1959,762,2022-04-24,116,41,118,77,2025-07-23 23:42:38.107819
1960,1082,2022-11-13,164,166,351,185,2025-07-23 23:42:38.109199
1961,845,2022-10-11,245,124,234,110,2025-07-23 23:42:38.110227
1962,809,2023-03-02,248,283,481,198,2025-07-23 23:42:38.111217
1963,823,2022-04-27,99,59,104,45,2025-07-23 23:42:38.112405
1964,360,2023-03-12,64,65,109,44,2025-07-23 23:42:38.113476
1965,215,2023-04-17,86,156,177,21,2025-07-23 23:42:38.114461
1966,453,2022-03-27,144,34,106,72,2025-07-23 23:42:38.115451
1967,1129,2022-08-29,39,100,202,102,2025-07-23 23:42:38.116438
1968,98,2024-08-09,90,67,118,51,2025-07-23 23:42:38.117416
1969,447,2023-03-22,112,90,461,371,2025-07-23 23:42:38.118381
1970,959,2022-12-23,167,198,401,203,2025-07-23 23:42:38.119599
1971,1407,2022-12-05,134,38,216,178,2025-07-23 23:42:38.120945
1972,1235,2023-03-15,182,49,70,21,2025-07-23 23:42:38.121959
1973,412,2022-07-29,184,41,215,174,2025-07-23 23:42:38.122903
1974,219,2023-02-07,107,129,166,37,2025-07-23 23:42:38.123893
1975,1336,2023-07-12,220,96,121,25,2025-07-23 23:42:38.124872
1976,836,2023-04-08,3,280,405,125,2025-07-23 23:42:38.125859
1977,388,2022-02-19,41,116,217,101,2025-07-23 23:42:38.126853
1978,116,2022-12-14,108,24,319,295,2025-07-23 23:42:38.127837
1979,262,2024-11-05,32,294,398,104,2025-07-23 23:42:38.128842
1980,1125,2022-05-27,249,136,483,347,2025-07-23 23:42:38.129821
1981,1023,2024-07-14,191,104,258,154,2025-07-23 23:42:38.130791
1982,123,2022-01-02,243,451,497,46,2025-07-23 23:42:38.131736
1983,1143,2024-09-12,124,217,384,167,2025-07-23 23:42:38.132686
1984,721,2024-04-25,46,335,455,120,2025-07-23 23:42:38.133650
1985,116,2022-01-26,198,58,499,441,2025-07-23 23:42:38.134618
1986,135,2022-11-27,138,26,485,459,2025-07-23 23:42:38.135588
1987,839,2023-11-21,229,131,161,30,2025-07-23 23:42:38.136549
1988,267,2024-10-15,94,163,231,68,2025-07-23 23:42:38.137499
1989,1119,2023-03-29,166,195,308,113,2025-07-23 23:42:38.138460
1990,880,2022-10-17,185,42,78,36,2025-07-23 23:42:38.139430
1991,1302,2022-07-29,15,332,338,6,2025-07-23 23:42:38.140386
1992,810,2022-12-14,127,31,448,417,2025-07-23 23:42:38.141336
1993,1420,2023-07-13,226,241,431,190,2025-07-23 23:42:38.142292
1994,917,2023-02-25,151,222,328,106,2025-07-23 23:42:38.143250
1995,810,2022-02-02,40,182,310,128,2025-07-23 23:42:38.144199
1996,1124,2022-09-25,197,82,188,106,2025-07-23 23:42:38.145163
1997,189,2023-08-31,184,178,322,144,2025-07-23 23:42:38.146128
1998,34,2023-12-19,143,25,188,163,2025-07-23 23:42:38.147105
1999,1474,2024-11-16,50,262,340,78,2025-07-23 23:42:38.148042
2000,817,2023-03-03,139,59,167,108,2025-07-23 23:42:38.149015
2001,268,2023-10-16,181,5,18,13,2025-07-23 23:42:38.149966
2002,916,2022-08-05,2,116,127,11,2025-07-23 23:42:38.151080
2003,1002,2022-02-06,211,158,223,65,2025-07-23 23:42:38.152221
2004,438,2022-12-04,158,1,88,87,2025-07-23 23:42:38.153266
2005,530,2022-10-14,62,66,256,190,2025-07-23 23:42:38.154408
2006,855,2022-06-24,7,315,425,110,2025-07-23 23:42:38.155407
2007,1319,2022-06-06,23,20,129,109,2025-07-23 23:42:38.156409
2008,302,2022-05-07,73,43,183,140,2025-07-23 23:42:38.157581
2009,1467,2022-02-13,114,203,228,25,2025-07-23 23:42:38.158662
2010,335,2022-01-11,31,362,376,14,2025-07-23 23:42:38.159691
2011,1428,2022-09-21,62,15,94,79,2025-07-23 23:42:38.160663
2012,83,2023-08-15,219,450,483,33,2025-07-23 23:42:38.161922
2013,134,2023-06-01,63,334,358,24,2025-07-23 23:42:38.162957
2014,1276,2023-06-25,14,23,202,179,2025-07-23 23:42:38.163930
2015,133,2023-06-03,206,16,53,37,2025-07-23 23:42:38.164890
2016,519,2022-06-29,250,120,160,40,2025-07-23 23:42:38.165883
2017,764,2023-07-04,76,311,482,171,2025-07-23 23:42:38.166876
2018,316,2022-03-19,201,138,206,68,2025-07-23 23:42:38.167873
2019,1153,2022-03-27,121,91,268,177,2025-07-23 23:42:38.168874
2020,1123,2024-08-06,72,249,320,71,2025-07-23 23:42:38.169858
2021,840,2023-06-24,228,89,146,57,2025-07-23 23:42:38.170889
2022,648,2022-06-13,29,328,422,94,2025-07-23 23:42:38.171907
2023,857,2023-03-08,190,65,382,317,2025-07-23 23:42:38.173073
2024,195,2022-09-04,183,50,108,58,2025-07-23 23:42:38.174103
2025,463,2022-08-24,90,13,184,171,2025-07-23 23:42:38.175067
2026,645,2022-05-03,118,56,73,17,2025-07-23 23:42:38.176056
2027,497,2022-06-04,46,356,401,45,2025-07-23 23:42:38.177025
2028,171,2023-07-08,245,48,124,76,2025-07-23 23:42:38.177982
2029,1264,2024-12-13,177,5,75,70,2025-07-23 23:42:38.178992
2030,667,2023-07-08,231,40,235,195,2025-07-23 23:42:38.179929
2031,180,2024-11-28,189,110,204,94,2025-07-23 23:42:38.180903
2032,1445,2024-04-26,89,41,470,429,2025-07-23 23:42:38.181884
2033,713,2023-03-01,38,11,111,100,2025-07-23 23:42:38.182871
2034,23,2023-11-27,200,87,347,260,2025-07-23 23:42:38.183857
2035,692,2023-09-20,36,68,281,213,2025-07-23 23:42:38.184842
2036,1184,2023-01-04,194,21,336,315,2025-07-23 23:42:38.185842
2037,549,2024-01-21,196,25,304,279,2025-07-23 23:42:38.187054
2038,131,2024-09-23,163,281,367,86,2025-07-23 23:42:38.188156
2039,1467,2022-01-01,109,258,360,102,2025-07-23 23:42:38.189204
2040,98,2023-01-27,97,65,499,434,2025-07-23 23:42:38.190171
2041,485,2024-10-28,75,112,129,17,2025-07-23 23:42:38.191156
2042,375,2023-06-28,24,135,251,116,2025-07-23 23:42:38.192149
2043,875,2023-06-08,212,109,382,273,2025-07-23 23:42:38.193142
2044,1213,2023-01-13,108,18,81,63,2025-07-23 23:42:38.194100
2045,76,2024-04-02,148,388,401,13,2025-07-23 23:42:38.195076
2046,189,2023-12-24,139,188,291,103,2025-07-23 23:42:38.196002
2047,1267,2024-11-29,129,144,190,46,2025-07-23 23:42:38.196944
2048,3,2022-08-12,93,118,130,12,2025-07-23 23:42:38.197885
2049,27,2024-02-17,38,19,55,36,2025-07-23 23:42:38.198900
2050,1117,2024-08-01,174,27,263,236,2025-07-23 23:42:38.199881
2051,355,2024-08-14,153,50,86,36,2025-07-23 23:42:38.200848
2052,256,2022-07-29,165,8,54,46,2025-07-23 23:42:38.201804
2053,1254,2024-01-19,1,63,78,15,2025-07-23 23:42:38.202742
2054,435,2022-01-19,249,34,469,435,2025-07-23 23:42:38.203697
2055,73,2022-06-23,130,216,355,139,2025-07-23 23:42:38.204651
2056,458,2022-12-25,89,166,388,222,2025-07-23 23:42:38.205595
2057,1035,2022-07-15,179,13,155,142,2025-07-23 23:42:38.206547
2058,1355,2022-09-08,244,108,154,46,2025-07-23 23:42:38.207495
2059,365,2022-06-16,224,4,52,48,2025-07-23 23:42:38.208467
2060,1140,2022-09-11,96,235,307,72,2025-07-23 23:42:38.209450
2061,150,2023-08-18,112,101,465,364,2025-07-23 23:42:38.210407
2062,1421,2022-02-03,239,1,21,20,2025-07-23 23:42:38.211349
2063,977,2023-02-03,185,50,470,420,2025-07-23 23:42:38.212300
2064,662,2022-05-07,114,51,144,93,2025-07-23 23:42:38.213258
2065,225,2024-01-04,246,170,325,155,2025-07-23 23:42:38.214202
2066,643,2024-01-21,130,59,316,257,2025-07-23 23:42:38.215157
2067,1191,2023-02-13,63,51,360,309,2025-07-23 23:42:38.216138
2068,1268,2024-11-10,61,4,277,273,2025-07-23 23:42:38.217057
2069,966,2023-10-30,117,408,493,85,2025-07-23 23:42:38.218058
2070,725,2022-02-10,2,7,36,29,2025-07-23 23:42:38.219008
2071,370,2023-03-19,159,64,76,12,2025-07-23 23:42:38.219951
2072,795,2022-11-21,249,88,278,190,2025-07-23 23:42:38.220877
2073,345,2023-09-06,57,9,193,184,2025-07-23 23:42:38.221841
2074,290,2022-09-30,206,156,343,187,2025-07-23 23:42:38.222783
2075,869,2024-05-05,210,253,337,84,2025-07-23 23:42:38.223735
2076,1432,2022-06-14,131,268,277,9,2025-07-23 23:42:38.224777
2077,1308,2022-12-30,234,131,276,145,2025-07-23 23:42:38.225501
2078,1450,2022-03-13,120,126,377,251,2025-07-23 23:42:38.226141
2079,930,2024-09-22,184,7,82,75,2025-07-23 23:42:38.226752
2080,194,2022-06-30,16,149,270,121,2025-07-23 23:42:38.227386
2081,487,2023-10-26,22,78,255,177,2025-07-23 23:42:38.228023
2082,1120,2024-03-13,250,37,133,96,2025-07-23 23:42:38.228650
2083,548,2023-10-27,71,25,42,17,2025-07-23 23:42:38.229307
2084,1401,2022-03-05,105,17,420,403,2025-07-23 23:42:38.229931
2085,1004,2024-09-26,212,67,184,117,2025-07-23 23:42:38.230549
2086,647,2022-05-02,192,99,130,31,2025-07-23 23:42:38.231191
2087,397,2023-08-03,158,112,479,367,2025-07-23 23:42:38.231827
2088,719,2023-09-16,175,100,219,119,2025-07-23 23:42:38.232474
2089,1481,2023-06-04,118,46,479,433,2025-07-23 23:42:38.233140
2090,983,2024-05-13,184,25,194,169,2025-07-23 23:42:38.233752
2091,1469,2023-10-11,113,90,222,132,2025-07-23 23:42:38.234472
2092,214,2022-12-04,47,30,51,21,2025-07-23 23:42:38.235112
2093,352,2022-08-22,179,90,447,357,2025-07-23 23:42:38.235713
2094,10,2024-12-27,81,411,453,42,2025-07-23 23:42:38.236363
2095,1284,2022-01-06,69,29,304,275,2025-07-23 23:42:38.237031
2096,1089,2022-09-05,231,4,33,29,2025-07-23 23:42:38.237671
2097,1464,2022-07-11,144,4,10,6,2025-07-23 23:42:38.238309
2098,369,2022-12-13,33,15,232,217,2025-07-23 23:42:38.238919
2099,775,2024-08-24,95,246,472,226,2025-07-23 23:42:38.239527
2100,385,2023-12-18,80,116,327,211,2025-07-23 23:42:38.240163
2101,426,2024-11-12,137,209,244,35,2025-07-23 23:42:38.240774
2102,492,2022-11-04,63,98,133,35,2025-07-23 23:42:38.241392
2103,592,2024-04-09,90,15,32,17,2025-07-23 23:42:38.242002
2104,104,2022-05-24,81,0,51,51,2025-07-23 23:42:38.242621
2105,1041,2024-04-01,207,269,473,204,2025-07-23 23:42:38.243265
2106,255,2022-02-08,198,33,128,95,2025-07-23 23:42:38.243872
2107,1313,2023-10-02,33,198,313,115,2025-07-23 23:42:38.244478
2108,504,2022-04-27,221,149,206,57,2025-07-23 23:42:38.245096
2109,500,2024-08-31,157,38,334,296,2025-07-23 23:42:38.245719
2110,497,2022-08-03,124,66,445,379,2025-07-23 23:42:38.246376
2111,154,2022-12-13,161,242,267,25,2025-07-23 23:42:38.246984
2112,995,2022-03-15,114,100,215,115,2025-07-23 23:42:38.247582
2113,696,2024-01-15,238,54,355,301,2025-07-23 23:42:38.248205
2114,1273,2024-09-29,7,26,243,217,2025-07-23 23:42:38.248849
2115,1082,2023-11-11,81,46,352,306,2025-07-23 23:42:38.249487
2116,900,2023-11-01,206,215,292,77,2025-07-23 23:42:38.250112
2117,501,2022-02-27,239,252,289,37,2025-07-23 23:42:38.250699
2118,874,2024-03-15,185,160,248,88,2025-07-23 23:42:38.251327
2119,1315,2024-12-14,127,84,337,253,2025-07-23 23:42:38.251932
2120,280,2023-08-27,145,15,295,280,2025-07-23 23:42:38.252538
2121,81,2023-08-31,193,41,48,7,2025-07-23 23:42:38.253162
2122,766,2022-08-21,113,287,397,110,2025-07-23 23:42:38.253746
2123,451,2022-09-12,71,58,113,55,2025-07-23 23:42:38.254398
2124,38,2022-06-25,4,283,293,10,2025-07-23 23:42:38.255024
2125,809,2023-06-23,10,106,158,52,2025-07-23 23:42:38.255628
2126,1286,2023-02-03,13,55,159,104,2025-07-23 23:42:38.256251
2127,1257,2024-12-12,77,34,149,115,2025-07-23 23:42:38.256873
2128,1161,2024-05-10,239,392,414,22,2025-07-23 23:42:38.257477
2129,851,2023-03-07,41,89,316,227,2025-07-23 23:42:38.258107
2130,1476,2023-03-05,117,8,130,122,2025-07-23 23:42:38.258696
2131,1227,2024-07-09,127,178,225,47,2025-07-23 23:42:38.259329
2132,20,2023-10-23,168,250,359,109,2025-07-23 23:42:38.259931
2133,84,2024-07-25,233,131,302,171,2025-07-23 23:42:38.260531
2134,346,2024-04-15,168,198,431,233,2025-07-23 23:42:38.261413
2135,1462,2024-11-14,210,119,449,330,2025-07-23 23:42:38.262342
2136,945,2023-11-29,58,323,408,85,2025-07-23 23:42:38.263307
2137,1160,2024-01-08,10,138,179,41,2025-07-23 23:42:38.264283
2138,87,2023-06-05,127,54,82,28,2025-07-23 23:42:38.265241
2139,509,2023-06-16,94,123,260,137,2025-07-23 23:42:38.266393
2140,1436,2023-03-29,246,215,350,135,2025-07-23 23:42:38.267413
2141,622,2023-03-12,149,0,32,32,2025-07-23 23:42:38.268470
2142,756,2024-06-25,167,3,11,8,2025-07-23 23:42:38.269547
2143,688,2024-10-13,46,69,180,111,2025-07-23 23:42:38.270715
2144,462,2024-08-24,25,46,113,67,2025-07-23 23:42:38.271843
2145,132,2022-03-09,168,331,428,97,2025-07-23 23:42:38.272814
2146,145,2024-10-30,156,137,155,18,2025-07-23 23:42:38.273784
2147,606,2024-09-04,145,21,208,187,2025-07-23 23:42:38.274743
2148,699,2022-07-31,117,13,29,16,2025-07-23 23:42:38.275698
2149,986,2022-02-03,121,112,350,238,2025-07-23 23:42:38.276645
2150,482,2024-04-18,171,143,455,312,2025-07-23 23:42:38.277594
2151,1006,2022-08-16,183,81,366,285,2025-07-23 23:42:38.278876
2152,30,2022-05-26,157,69,178,109,2025-07-23 23:42:38.279897
2153,953,2022-03-24,233,147,211,64,2025-07-23 23:42:38.280929
2154,448,2023-06-20,232,367,393,26,2025-07-23 23:42:38.281914
2155,129,2023-02-21,32,48,223,175,2025-07-23 23:42:38.282896
2156,532,2022-01-30,157,37,239,202,2025-07-23 23:42:38.283884
2157,1249,2023-06-18,203,14,100,86,2025-07-23 23:42:38.284877
2158,475,2022-02-15,46,141,213,72,2025-07-23 23:42:38.285870
2159,290,2022-11-28,17,0,173,173,2025-07-23 23:42:38.286983
2160,104,2024-09-21,208,175,228,53,2025-07-23 23:42:38.288012
2161,189,2022-04-27,215,69,490,421,2025-07-23 23:42:38.289041
2162,1401,2022-12-26,224,407,414,7,2025-07-23 23:42:38.290003
2163,177,2024-09-27,82,201,285,84,2025-07-23 23:42:38.290965
2164,999,2024-05-17,145,132,239,107,2025-07-23 23:42:38.291946
2165,331,2022-01-13,250,98,332,234,2025-07-23 23:42:38.292912
2166,699,2023-12-17,64,129,204,75,2025-07-23 23:42:38.293882
2167,1069,2024-11-15,125,13,48,35,2025-07-23 23:42:38.294853
2168,362,2024-03-18,29,24,283,259,2025-07-23 23:42:38.295795
2169,1253,2024-10-13,65,18,25,7,2025-07-23 23:42:38.296725
2170,1219,2023-05-03,86,15,35,20,2025-07-23 23:42:38.297710
2171,151,2023-11-13,176,64,129,65,2025-07-23 23:42:38.298670
2172,1197,2022-07-03,222,175,351,176,2025-07-23 23:42:38.299611
2173,1355,2024-09-11,169,105,244,139,2025-07-23 23:42:38.300552
2174,239,2022-12-22,132,191,407,216,2025-07-23 23:42:38.301682
2175,1021,2022-05-05,142,37,282,245,2025-07-23 23:42:38.302728
2176,528,2023-03-25,110,203,208,5,2025-07-23 23:42:38.303729
2177,30,2023-06-02,187,10,95,85,2025-07-23 23:42:38.304748
2178,796,2023-08-19,105,69,126,57,2025-07-23 23:42:38.305739
2179,1298,2023-01-17,233,2,394,392,2025-07-23 23:42:38.306725
2180,1483,2022-05-29,179,307,375,68,2025-07-23 23:42:38.307685
2181,195,2024-07-13,42,157,385,228,2025-07-23 23:42:38.308676
2182,971,2023-11-12,191,66,194,128,2025-07-23 23:42:38.309619
2183,675,2023-04-07,164,23,63,40,2025-07-23 23:42:38.310634
2184,186,2024-04-12,74,95,151,56,2025-07-23 23:42:38.311893
2185,1026,2022-06-30,51,359,467,108,2025-07-23 23:42:38.312882
2186,212,2022-11-22,230,0,283,283,2025-07-23 23:42:38.314101
2187,742,2023-05-12,25,247,416,169,2025-07-23 23:42:38.315153
2188,1351,2024-11-16,144,443,488,45,2025-07-23 23:42:38.316159
2189,220,2024-05-19,159,214,464,250,2025-07-23 23:42:38.317160
2190,468,2023-01-18,209,285,391,106,2025-07-23 23:42:38.318306
2191,584,2022-12-15,160,199,340,141,2025-07-23 23:42:38.319370
2192,1425,2023-07-05,246,88,227,139,2025-07-23 23:42:38.320343
2193,307,2023-05-04,64,346,419,73,2025-07-23 23:42:38.321198
2194,94,2023-12-12,121,8,128,120,2025-07-23 23:42:38.321875
2195,8,2023-11-03,23,133,156,23,2025-07-23 23:42:38.322550
2196,167,2023-04-18,17,23,66,43,2025-07-23 23:42:38.323241
2197,829,2023-12-12,101,103,131,28,2025-07-23 23:42:38.323903
2198,194,2024-08-07,231,62,84,22,2025-07-23 23:42:38.324838
2199,411,2023-06-18,177,22,38,16,2025-07-23 23:42:38.325740
2200,282,2023-05-19,25,80,108,28,2025-07-23 23:42:38.326732
2201,904,2024-09-16,113,105,212,107,2025-07-23 23:42:38.327683
2202,1218,2024-06-16,90,40,57,17,2025-07-23 23:42:38.328646
2203,1382,2024-05-22,25,5,11,6,2025-07-23 23:42:38.329579
2204,633,2024-02-09,190,6,276,270,2025-07-23 23:42:38.330531
2205,294,2024-05-01,81,50,157,107,2025-07-23 23:42:38.331455
2206,1175,2024-07-07,105,132,155,23,2025-07-23 23:42:38.332429
2207,181,2023-03-30,11,56,99,43,2025-07-23 23:42:38.333384
2208,428,2024-10-20,92,108,399,291,2025-07-23 23:42:38.334358
2209,442,2023-12-01,133,289,365,76,2025-07-23 23:42:38.335342
2210,59,2024-01-24,231,33,108,75,2025-07-23 23:42:38.336318
2211,929,2024-06-18,77,220,327,107,2025-07-23 23:42:38.337296
2212,1357,2024-12-21,37,203,434,231,2025-07-23 23:42:38.338256
2213,1222,2022-09-01,141,206,216,10,2025-07-23 23:42:38.339202
2214,563,2023-09-14,235,255,314,59,2025-07-23 23:42:38.340188
2215,438,2022-08-09,32,18,85,67,2025-07-23 23:42:38.341187
2216,1284,2022-11-20,115,69,282,213,2025-07-23 23:42:38.342154
2217,1392,2024-05-14,111,149,442,293,2025-07-23 23:42:38.343133
2218,109,2023-02-04,76,3,40,37,2025-07-23 23:42:38.344087
2219,596,2022-10-21,54,119,351,232,2025-07-23 23:42:38.345024
2220,1051,2023-09-04,119,144,204,60,2025-07-23 23:42:38.345967
2221,81,2024-12-15,103,143,327,184,2025-07-23 23:42:38.346994
2222,87,2023-07-01,96,164,307,143,2025-07-23 23:42:38.348165
2223,1317,2024-09-01,139,127,242,115,2025-07-23 23:42:38.349161
2224,207,2024-11-24,137,252,272,20,2025-07-23 23:42:38.350160
2225,1002,2022-11-14,98,428,469,41,2025-07-23 23:42:38.351139
2226,1273,2022-10-27,181,326,412,86,2025-07-23 23:42:38.352134
2227,1429,2022-03-28,43,199,237,38,2025-07-23 23:42:38.352777
2228,614,2024-11-03,179,228,278,50,2025-07-23 23:42:38.353448
2229,179,2023-07-01,174,28,123,95,2025-07-23 23:42:38.354112
2230,917,2022-06-17,128,26,106,80,2025-07-23 23:42:38.354724
2231,833,2024-05-21,191,196,288,92,2025-07-23 23:42:38.355374
2232,885,2024-12-21,68,41,55,14,2025-07-23 23:42:38.356030
2233,370,2023-02-02,125,34,126,92,2025-07-23 23:42:38.356673
2234,1096,2024-03-09,174,14,32,18,2025-07-23 23:42:38.357331
2235,23,2024-09-05,108,215,253,38,2025-07-23 23:42:38.357974
2236,1003,2024-03-04,30,205,347,142,2025-07-23 23:42:38.358577
2237,13,2024-01-17,184,33,495,462,2025-07-23 23:42:38.359219
2238,41,2023-09-19,17,314,319,5,2025-07-23 23:42:38.359845
2239,1235,2023-04-24,93,66,211,145,2025-07-23 23:42:38.360458
2240,1021,2022-03-14,141,106,300,194,2025-07-23 23:42:38.361093
2241,401,2024-06-16,60,3,12,9,2025-07-23 23:42:38.361683
2242,228,2022-12-07,9,48,479,431,2025-07-23 23:42:38.362301
2243,963,2024-07-09,179,82,138,56,2025-07-23 23:42:38.362941
2244,506,2023-12-10,216,152,250,98,2025-07-23 23:42:38.363547
2245,777,2024-06-30,57,138,205,67,2025-07-23 23:42:38.364183
2246,1335,2024-02-22,151,94,388,294,2025-07-23 23:42:38.364795
2247,931,2023-10-23,80,396,499,103,2025-07-23 23:42:38.365418
2248,764,2024-08-28,51,110,306,196,2025-07-23 23:42:38.366060
2249,346,2022-11-16,84,47,75,28,2025-07-23 23:42:38.366628
2250,202,2024-04-28,205,73,124,51,2025-07-23 23:42:38.367299
2251,978,2024-02-12,245,149,313,164,2025-07-23 23:42:38.367921
2252,969,2022-06-02,90,110,211,101,2025-07-23 23:42:38.368515
2253,1042,2024-02-21,38,382,440,58,2025-07-23 23:42:38.369181
2254,1173,2022-05-09,137,85,194,109,2025-07-23 23:42:38.369802
2255,1368,2023-07-11,7,419,475,56,2025-07-23 23:42:38.370463
2256,472,2024-11-26,15,8,28,20,2025-07-23 23:42:38.371096
2257,616,2022-11-08,195,34,97,63,2025-07-23 23:42:38.371715
2258,870,2023-11-24,189,49,112,63,2025-07-23 23:42:38.372360
2259,1497,2023-08-19,22,186,450,264,2025-07-23 23:42:38.373026
2260,295,2023-12-06,147,30,465,435,2025-07-23 23:42:38.373656
2261,1274,2024-05-20,233,31,238,207,2025-07-23 23:42:38.374379
2262,1141,2024-07-21,71,70,391,321,2025-07-23 23:42:38.375073
2263,701,2022-10-08,93,77,145,68,2025-07-23 23:42:38.375689
2264,1181,2023-03-29,48,41,114,73,2025-07-23 23:42:38.376364
2265,721,2022-02-15,75,148,264,116,2025-07-23 23:42:38.377048
2266,1051,2023-06-16,217,91,195,104,2025-07-23 23:42:38.377654
2267,145,2023-11-04,15,85,153,68,2025-07-23 23:42:38.378361
2268,95,2023-02-01,203,4,43,39,2025-07-23 23:42:38.379047
2269,230,2023-01-31,14,403,423,20,2025-07-23 23:42:38.379630
2270,826,2023-06-19,16,312,428,116,2025-07-23 23:42:38.380248
2271,322,2022-11-07,142,211,361,150,2025-07-23 23:42:38.380851
2272,176,2022-02-17,242,112,172,60,2025-07-23 23:42:38.381445
2273,243,2024-06-24,215,239,437,198,2025-07-23 23:42:38.382059
2274,60,2022-06-18,85,101,477,376,2025-07-23 23:42:38.382629
2275,1231,2024-05-16,62,140,225,85,2025-07-23 23:42:38.383260
2276,923,2023-06-11,72,296,467,171,2025-07-23 23:42:38.383874
2277,539,2022-07-04,134,204,469,265,2025-07-23 23:42:38.384497
2278,285,2024-12-10,121,102,122,20,2025-07-23 23:42:38.385122
2279,493,2024-12-20,206,347,476,129,2025-07-23 23:42:38.385716
2280,1217,2024-08-17,133,23,110,87,2025-07-23 23:42:38.386360
2281,71,2024-04-07,113,19,31,12,2025-07-23 23:42:38.386992
2282,931,2023-09-26,199,216,325,109,2025-07-23 23:42:38.387577
2283,594,2023-08-24,21,23,190,167,2025-07-23 23:42:38.388398
2284,1410,2024-12-06,67,123,222,99,2025-07-23 23:42:38.389470
2285,862,2022-05-13,160,52,151,99,2025-07-23 23:42:38.390538
2286,1039,2023-04-22,63,124,181,57,2025-07-23 23:42:38.391443
2287,523,2022-12-01,213,34,39,5,2025-07-23 23:42:38.392133
2288,383,2024-12-11,58,282,386,104,2025-07-23 23:42:38.392744
2289,1175,2022-06-03,65,151,470,319,2025-07-23 23:42:38.393437
2290,339,2023-05-01,26,288,381,93,2025-07-23 23:42:38.394137
2291,306,2022-12-15,43,72,108,36,2025-07-23 23:42:38.394734
2292,38,2022-12-19,196,18,236,218,2025-07-23 23:42:38.395418
2293,496,2022-10-25,85,298,371,73,2025-07-23 23:42:38.396106
2294,1415,2024-07-02,7,345,357,12,2025-07-23 23:42:38.396724
2295,1282,2022-06-09,240,118,341,223,2025-07-23 23:42:38.397405
2296,368,2022-01-12,88,143,206,63,2025-07-23 23:42:38.398082
2297,488,2022-07-16,64,39,187,148,2025-07-23 23:42:38.398686
2298,227,2024-01-01,93,258,365,107,2025-07-23 23:42:38.399340
2299,651,2022-12-19,220,119,129,10,2025-07-23 23:42:38.399947
2300,1485,2023-03-28,199,259,382,123,2025-07-23 23:42:38.400543
2301,1137,2024-08-06,181,134,170,36,2025-07-23 23:42:38.401197
2302,1271,2022-06-21,28,23,142,119,2025-07-23 23:42:38.401801
2303,330,2024-12-12,93,84,277,193,2025-07-23 23:42:38.402414
2304,571,2022-07-22,219,150,217,67,2025-07-23 23:42:38.403112
2305,165,2023-09-13,206,99,206,107,2025-07-23 23:42:38.403722
2306,1113,2024-02-28,157,89,303,214,2025-07-23 23:42:38.404398
2307,488,2024-03-16,128,228,387,159,2025-07-23 23:42:38.405040
2308,1319,2024-11-25,141,154,329,175,2025-07-23 23:42:38.405650
2309,1499,2024-11-26,179,266,414,148,2025-07-23 23:42:38.406315
2310,1310,2024-02-17,157,177,472,295,2025-07-23 23:42:38.406936
2311,1049,2023-09-27,88,345,387,42,2025-07-23 23:42:38.407502
2312,720,2022-12-22,169,93,328,235,2025-07-23 23:42:38.408140
2313,218,2023-05-20,19,337,473,136,2025-07-23 23:42:38.408773
2314,842,2023-11-12,112,263,269,6,2025-07-23 23:42:38.409389
2315,48,2023-10-14,3,343,414,71,2025-07-23 23:42:38.410012
2316,348,2024-05-11,158,165,368,203,2025-07-23 23:42:38.410594
2317,345,2022-05-07,166,62,133,71,2025-07-23 23:42:38.411219
2318,454,2024-05-05,68,36,321,285,2025-07-23 23:42:38.411817
2319,197,2024-07-04,118,177,261,84,2025-07-23 23:42:38.412433
2320,52,2022-08-16,227,115,245,130,2025-07-23 23:42:38.413064
2321,1295,2023-08-31,126,65,424,359,2025-07-23 23:42:38.413668
2322,1135,2024-03-13,160,331,350,19,2025-07-23 23:42:38.414306
2323,1244,2022-03-15,166,169,338,169,2025-07-23 23:42:38.414933
2324,102,2024-05-20,99,343,466,123,2025-07-23 23:42:38.415525
2325,481,2024-10-29,228,130,141,11,2025-07-23 23:42:38.416151
2326,1190,2024-11-11,9,276,452,176,2025-07-23 23:42:38.416733
2327,636,2023-12-19,36,150,211,61,2025-07-23 23:42:38.417359
2328,245,2023-09-03,39,97,111,14,2025-07-23 23:42:38.417995
2329,1273,2022-11-12,90,140,240,100,2025-07-23 23:42:38.418585
2330,1225,2022-02-27,195,108,327,219,2025-07-23 23:42:38.419213
2331,1133,2024-02-09,184,47,201,154,2025-07-23 23:42:38.419818
2332,754,2022-10-16,166,136,463,327,2025-07-23 23:42:38.420426
2333,996,2024-08-20,162,6,34,28,2025-07-23 23:42:38.421053
2334,175,2024-04-15,210,152,297,145,2025-07-23 23:42:38.421636
2335,1162,2023-09-14,92,39,123,84,2025-07-23 23:42:38.422267
2336,318,2022-10-11,145,43,333,290,2025-07-23 23:42:38.422877
2337,304,2022-12-30,47,95,213,118,2025-07-23 23:42:38.423511
2338,884,2024-05-08,179,52,88,36,2025-07-23 23:42:38.424342
2339,46,2023-07-16,235,91,459,368,2025-07-23 23:42:38.425306
2340,1417,2022-02-17,158,154,349,195,2025-07-23 23:42:38.426349
2341,266,2022-07-21,200,73,291,218,2025-07-23 23:42:38.427286
2342,273,2022-11-17,97,98,193,95,2025-07-23 23:42:38.428206
2343,1077,2022-08-13,170,44,363,319,2025-07-23 23:42:38.429177
2344,997,2022-05-23,35,2,24,22,2025-07-23 23:42:38.430173
2345,146,2024-07-17,10,279,411,132,2025-07-23 23:42:38.431148
2346,177,2024-11-24,16,265,271,6,2025-07-23 23:42:38.432122
2347,704,2024-10-14,74,158,321,163,2025-07-23 23:42:38.433069
2348,376,2023-02-02,81,11,498,487,2025-07-23 23:42:38.434024
2349,346,2022-09-09,40,211,246,35,2025-07-23 23:42:38.435000
2350,1135,2022-01-22,133,47,323,276,2025-07-23 23:42:38.435923
2351,126,2022-06-08,144,139,217,78,2025-07-23 23:42:38.436852
2352,877,2024-04-08,49,411,469,58,2025-07-23 23:42:38.437811
2353,1416,2024-01-22,214,5,56,51,2025-07-23 23:42:38.438775
2354,558,2023-08-22,47,92,103,11,2025-07-23 23:42:38.439725
2355,1184,2024-10-26,196,214,478,264,2025-07-23 23:42:38.440708
2356,263,2023-02-26,18,335,358,23,2025-07-23 23:42:38.441648
2357,971,2024-04-26,110,14,69,55,2025-07-23 23:42:38.442600
2358,892,2024-01-27,239,78,227,149,2025-07-23 23:42:38.443550
2359,940,2023-01-20,44,31,391,360,2025-07-23 23:42:38.444487
2360,1409,2022-07-16,39,126,144,18,2025-07-23 23:42:38.445458
2361,352,2024-03-04,140,160,238,78,2025-07-23 23:42:38.446427
2362,785,2022-09-09,250,56,287,231,2025-07-23 23:42:38.447375
2363,67,2022-10-20,104,156,221,65,2025-07-23 23:42:38.448313
2364,737,2023-03-24,14,233,238,5,2025-07-23 23:42:38.449278
2365,687,2024-11-15,54,5,27,22,2025-07-23 23:42:38.450238
2366,1351,2022-02-22,198,185,199,14,2025-07-23 23:42:38.451189
2367,1354,2022-10-24,219,0,12,12,2025-07-23 23:42:38.452150
2368,1025,2022-03-24,134,160,214,54,2025-07-23 23:42:38.453139
2369,1062,2024-04-04,2,360,477,117,2025-07-23 23:42:38.454333
2370,1202,2022-01-04,37,207,298,91,2025-07-23 23:42:38.455364
2371,700,2022-12-22,102,324,366,42,2025-07-23 23:42:38.456447
2372,570,2023-03-20,40,420,455,35,2025-07-23 23:42:38.457472
2373,1026,2024-10-15,14,265,492,227,2025-07-23 23:42:38.458444
2374,1492,2023-10-03,24,65,72,7,2025-07-23 23:42:38.459439
2375,644,2023-12-12,240,68,155,87,2025-07-23 23:42:38.460427
2376,91,2023-10-02,228,6,55,49,2025-07-23 23:42:38.461882
2377,1294,2024-01-24,215,268,349,81,2025-07-23 23:42:38.462869
2378,1300,2023-01-26,146,20,104,84,2025-07-23 23:42:38.463873
2379,1432,2022-08-15,61,195,472,277,2025-07-23 23:42:38.464868
2380,550,2022-08-17,113,305,436,131,2025-07-23 23:42:38.465878
2381,821,2023-02-20,104,273,290,17,2025-07-23 23:42:38.466873
2382,451,2024-12-26,128,93,413,320,2025-07-23 23:42:38.467870
2383,327,2022-10-06,156,96,301,205,2025-07-23 23:42:38.468885
2384,828,2024-09-19,144,231,363,132,2025-07-23 23:42:38.469875
2385,483,2023-08-08,216,69,239,170,2025-07-23 23:42:38.470876
2386,97,2024-04-20,10,13,42,29,2025-07-23 23:42:38.471878
2387,967,2023-07-08,147,411,467,56,2025-07-23 23:42:38.472869
2388,329,2023-07-16,237,75,293,218,2025-07-23 23:42:38.473860
2389,638,2023-10-24,131,135,356,221,2025-07-23 23:42:38.474860
2390,839,2024-11-30,43,327,431,104,2025-07-23 23:42:38.475883
2391,893,2024-08-19,162,338,482,144,2025-07-23 23:42:38.476872
2392,218,2024-01-15,207,31,75,44,2025-07-23 23:42:38.477858
2393,44,2023-08-01,121,197,329,132,2025-07-23 23:42:38.478856
2394,984,2024-06-14,164,352,389,37,2025-07-23 23:42:38.479833
2395,984,2022-04-03,126,266,374,108,2025-07-23 23:42:38.480785
2396,1260,2022-08-07,20,113,331,218,2025-07-23 23:42:38.481726
2397,1323,2022-07-24,45,189,291,102,2025-07-23 23:42:38.482789
2398,1035,2024-01-19,140,1,16,15,2025-07-23 23:42:38.483814
2399,1200,2023-03-25,99,103,364,261,2025-07-23 23:42:38.484884
2400,1191,2023-07-18,59,138,190,52,2025-07-23 23:42:38.485862
2401,1463,2024-03-05,153,454,468,14,2025-07-23 23:42:38.486801
2402,874,2022-11-09,59,326,386,60,2025-07-23 23:42:38.487783
2403,787,2024-09-17,135,290,436,146,2025-07-23 23:42:38.488799
2404,1012,2022-06-03,59,204,467,263,2025-07-23 23:42:38.489777
2405,148,2023-03-09,27,337,483,146,2025-07-23 23:42:38.490801
2406,336,2022-06-14,45,211,231,20,2025-07-23 23:42:38.491793
2407,554,2022-02-07,141,394,443,49,2025-07-23 23:42:38.492728
2408,1444,2023-07-09,48,156,236,80,2025-07-23 23:42:38.493695
2409,483,2022-01-05,243,187,458,271,2025-07-23 23:42:38.494665
2410,376,2022-05-27,98,86,273,187,2025-07-23 23:42:38.495625
2411,89,2024-08-06,174,156,165,9,2025-07-23 23:42:38.496660
2412,204,2024-08-27,191,27,429,402,2025-07-23 23:42:38.497608
2413,1149,2024-01-26,244,11,96,85,2025-07-23 23:42:38.498586
2414,913,2022-04-24,143,4,100,96,2025-07-23 23:42:38.499542
2415,148,2023-12-30,208,89,244,155,2025-07-23 23:42:38.500497
2416,677,2024-04-10,140,147,245,98,2025-07-23 23:42:38.501472
2417,929,2024-08-01,27,10,245,235,2025-07-23 23:42:38.502463
2418,237,2024-01-15,15,183,258,75,2025-07-23 23:42:38.503437
2419,265,2023-01-25,24,50,101,51,2025-07-23 23:42:38.504414
2420,1450,2023-03-10,117,21,88,67,2025-07-23 23:42:38.505368
2421,158,2022-10-22,90,66,217,151,2025-07-23 23:42:38.506327
2422,195,2022-03-30,148,323,458,135,2025-07-23 23:42:38.507263
2423,113,2022-10-21,242,40,158,118,2025-07-23 23:42:38.508188
2424,301,2023-01-29,72,48,267,219,2025-07-23 23:42:38.509221
2425,627,2024-07-13,194,7,35,28,2025-07-23 23:42:38.510189
2426,1041,2022-09-16,189,65,157,92,2025-07-23 23:42:38.511176
2427,254,2022-05-20,53,259,274,15,2025-07-23 23:42:38.512170
2428,1163,2024-12-28,233,7,54,47,2025-07-23 23:42:38.513395
2429,708,2023-08-01,250,301,310,9,2025-07-23 23:42:38.514614
2430,1441,2024-03-17,181,190,253,63,2025-07-23 23:42:38.515743
2431,1376,2023-04-09,197,406,432,26,2025-07-23 23:42:38.516915
2432,1275,2022-04-28,22,199,259,60,2025-07-23 23:42:38.517911
2433,1007,2022-09-18,104,64,411,347,2025-07-23 23:42:38.518887
2434,413,2024-11-11,108,251,335,84,2025-07-23 23:42:38.519867
2435,489,2023-08-03,38,242,357,115,2025-07-23 23:42:38.520899
2436,476,2024-06-18,7,15,49,34,2025-07-23 23:42:38.521891
2437,828,2022-10-16,60,43,82,39,2025-07-23 23:42:38.522867
2438,1190,2024-06-01,69,123,476,353,2025-07-23 23:42:38.523846
2439,696,2022-01-27,238,1,42,41,2025-07-23 23:42:38.524790
2440,1022,2022-06-20,61,362,479,117,2025-07-23 23:42:38.525719
2441,201,2023-01-27,14,221,426,205,2025-07-23 23:42:38.526679
2442,1413,2022-03-26,145,143,208,65,2025-07-23 23:42:38.527620
2443,119,2023-03-30,203,16,99,83,2025-07-23 23:42:38.528571
2444,915,2023-01-08,229,176,210,34,2025-07-23 23:42:38.529522
2445,487,2024-02-24,147,37,44,7,2025-07-23 23:42:38.530472
2446,350,2022-10-05,134,306,324,18,2025-07-23 23:42:38.531445
2447,199,2022-10-11,43,43,416,373,2025-07-23 23:42:38.532466
2448,1338,2022-06-18,47,38,124,86,2025-07-23 23:42:38.533461
2449,1059,2022-04-09,196,262,411,149,2025-07-23 23:42:38.534425
2450,424,2024-03-19,172,93,103,10,2025-07-23 23:42:38.535365
2451,1240,2024-01-05,67,26,45,19,2025-07-23 23:42:38.536367
2452,1120,2023-06-28,191,135,233,98,2025-07-23 23:42:38.537299
2453,1255,2022-08-03,187,283,463,180,2025-07-23 23:42:38.538243
2454,288,2022-12-13,222,171,200,29,2025-07-23 23:42:38.539196
2455,489,2023-08-08,191,12,28,16,2025-07-23 23:42:38.540156
2456,827,2023-10-06,160,271,377,106,2025-07-23 23:42:38.541110
2457,793,2024-09-06,58,198,258,60,2025-07-23 23:42:38.542054
2458,1067,2024-03-23,24,7,31,24,2025-07-23 23:42:38.543001
2459,428,2023-08-30,202,8,46,38,2025-07-23 23:42:38.543944
2460,1317,2022-07-27,222,190,202,12,2025-07-23 23:42:38.544894
2461,1058,2023-01-01,226,221,412,191,2025-07-23 23:42:38.545855
2462,638,2023-10-15,6,474,483,9,2025-07-23 23:42:38.546882
2463,135,2022-10-17,92,0,102,102,2025-07-23 23:42:38.548058
2464,32,2022-02-11,105,130,442,312,2025-07-23 23:42:38.549077
2465,182,2022-09-17,244,231,484,253,2025-07-23 23:42:38.550072
2466,1062,2024-10-31,174,405,440,35,2025-07-23 23:42:38.551043
2467,1056,2022-11-23,128,113,267,154,2025-07-23 23:42:38.552012
2468,559,2024-05-04,36,13,63,50,2025-07-23 23:42:38.553025
2469,660,2022-08-17,184,156,399,243,2025-07-23 23:42:38.553981
2470,64,2023-07-04,213,145,215,70,2025-07-23 23:42:38.554945
2471,1455,2024-01-17,148,90,289,199,2025-07-23 23:42:38.555870
2472,455,2022-11-04,133,121,188,67,2025-07-23 23:42:38.556882
2473,904,2024-02-17,46,13,27,14,2025-07-23 23:42:38.557858
2474,1221,2023-12-17,72,34,327,293,2025-07-23 23:42:38.558842
2475,128,2023-02-17,168,194,299,105,2025-07-23 23:42:38.559846
2476,266,2024-03-16,26,226,237,11,2025-07-23 23:42:38.560815
2477,798,2023-10-12,12,348,422,74,2025-07-23 23:42:38.561791
2478,1143,2024-01-31,22,35,64,29,2025-07-23 23:42:38.562728
2479,306,2024-02-13,238,52,71,19,2025-07-23 23:42:38.563687
2480,1131,2024-04-30,151,393,419,26,2025-07-23 23:42:38.564644
2481,919,2024-08-12,161,69,122,53,2025-07-23 23:42:38.565594
2482,157,2022-01-05,92,140,313,173,2025-07-23 23:42:38.566802
2483,764,2022-09-22,98,377,466,89,2025-07-23 23:42:38.567858
2484,636,2024-11-12,186,60,276,216,2025-07-23 23:42:38.568863
2485,280,2023-10-12,107,193,336,143,2025-07-23 23:42:38.569839
2486,756,2022-10-23,13,186,392,206,2025-07-23 23:42:38.570830
2487,1489,2024-08-16,92,107,145,38,2025-07-23 23:42:38.571801
2488,169,2024-05-06,183,249,447,198,2025-07-23 23:42:38.572742
2489,1035,2022-05-09,224,33,41,8,2025-07-23 23:42:38.573715
2490,1458,2022-03-21,245,415,447,32,2025-07-23 23:42:38.574671
2491,1471,2024-03-22,221,186,206,20,2025-07-23 23:42:38.575656
2492,231,2022-01-23,66,180,370,190,2025-07-23 23:42:38.576593
2493,659,2022-01-28,241,15,253,238,2025-07-23 23:42:38.577560
2494,1143,2024-06-28,142,85,453,368,2025-07-23 23:42:38.578516
2495,1365,2024-03-16,168,38,397,359,2025-07-23 23:42:38.579482
2496,1352,2023-09-06,175,77,492,415,2025-07-23 23:42:38.580449
2497,752,2022-07-22,19,143,161,18,2025-07-23 23:42:38.581431
2498,170,2023-11-01,188,72,167,95,2025-07-23 23:42:38.582387
2499,1158,2022-03-23,15,160,440,280,2025-07-23 23:42:38.583354
2500,810,2022-12-17,224,12,405,393,2025-07-23 23:42:38.584305
2501,815,2022-06-28,225,30,35,5,2025-07-23 23:42:38.585259
2502,1191,2022-02-02,71,231,494,263,2025-07-23 23:42:38.586194
2503,1044,2024-06-15,113,272,286,14,2025-07-23 23:42:38.587390
2504,1412,2024-11-14,89,120,211,91,2025-07-23 23:42:38.588385
2505,3,2023-05-13,12,3,32,29,2025-07-23 23:42:38.589386
2506,1201,2022-07-08,97,192,404,212,2025-07-23 23:42:38.590364
2507,888,2023-05-15,123,42,193,151,2025-07-23 23:42:38.591352
2508,544,2024-07-03,194,95,498,403,2025-07-23 23:42:38.592349
2509,802,2024-06-21,55,143,253,110,2025-07-23 23:42:38.593326
2510,1106,2023-02-25,24,83,124,41,2025-07-23 23:42:38.594288
2511,806,2023-12-06,243,150,199,49,2025-07-23 23:42:38.595248
2512,1291,2023-05-18,108,1,18,17,2025-07-23 23:42:38.596215
2513,1404,2022-10-07,92,18,466,448,2025-07-23 23:42:38.597212
2514,413,2024-05-09,3,44,219,175,2025-07-23 23:42:38.598169
2515,279,2023-02-08,108,63,271,208,2025-07-23 23:42:38.599142
2516,137,2022-01-25,111,88,375,287,2025-07-23 23:42:38.600130
2517,449,2024-03-10,14,48,128,80,2025-07-23 23:42:38.601135
2518,323,2024-07-19,105,5,125,120,2025-07-23 23:42:38.602073
2519,397,2022-06-08,162,26,81,55,2025-07-23 23:42:38.603018
2520,206,2024-04-14,57,68,111,43,2025-07-23 23:42:38.603968
2521,1337,2023-09-26,145,279,308,29,2025-07-23 23:42:38.604890
2522,255,2023-07-06,146,249,257,8,2025-07-23 23:42:38.605860
2523,117,2024-09-29,89,18,34,16,2025-07-23 23:42:38.606831
2524,1075,2022-01-21,145,371,412,41,2025-07-23 23:42:38.607785
2525,625,2022-10-22,113,37,42,5,2025-07-23 23:42:38.608751
2526,1195,2024-03-18,186,165,303,138,2025-07-23 23:42:38.609714
2527,150,2023-05-26,94,129,205,76,2025-07-23 23:42:38.610668
2528,864,2023-11-09,204,68,90,22,2025-07-23 23:42:38.611614
2529,419,2024-02-27,181,113,199,86,2025-07-23 23:42:38.612594
2530,1318,2023-07-17,221,220,249,29,2025-07-23 23:42:38.613562
2531,821,2024-08-17,158,88,350,262,2025-07-23 23:42:38.614529
2532,1332,2023-03-06,126,353,400,47,2025-07-23 23:42:38.615711
2533,1007,2022-12-23,62,465,483,18,2025-07-23 23:42:38.617078
2534,378,2022-12-06,57,3,94,91,2025-07-23 23:42:38.618036
2535,883,2024-03-28,164,147,244,97,2025-07-23 23:42:38.618997
2536,1400,2023-12-17,162,134,226,92,2025-07-23 23:42:38.620114
2537,256,2023-05-21,49,301,359,58,2025-07-23 23:42:38.621248
2538,505,2022-02-05,108,229,485,256,2025-07-23 23:42:38.622207
2539,1172,2024-10-17,194,114,170,56,2025-07-23 23:42:38.623205
2540,1338,2024-06-20,78,114,298,184,2025-07-23 23:42:38.624179
2541,1084,2023-06-10,70,89,142,53,2025-07-23 23:42:38.625179
2542,1453,2024-06-09,93,301,316,15,2025-07-23 23:42:38.626157
2543,141,2023-12-31,207,15,390,375,2025-07-23 23:42:38.627191
2544,1277,2022-07-02,9,90,100,10,2025-07-23 23:42:38.628147
2545,774,2023-05-11,76,310,355,45,2025-07-23 23:42:38.629157
2546,1035,2022-03-03,137,38,111,73,2025-07-23 23:42:38.630155
2547,196,2024-02-10,206,71,128,57,2025-07-23 23:42:38.631143
2548,991,2024-09-02,131,3,281,278,2025-07-23 23:42:38.632115
2549,408,2024-11-22,239,59,88,29,2025-07-23 23:42:38.633069
2550,1238,2023-11-17,161,7,43,36,2025-07-23 23:42:38.634018
2551,152,2024-02-20,175,189,234,45,2025-07-23 23:42:38.634993
2552,544,2022-12-19,226,75,87,12,2025-07-23 23:42:38.635959
2553,203,2022-10-30,38,180,213,33,2025-07-23 23:42:38.636909
2554,197,2024-03-12,210,116,133,17,2025-07-23 23:42:38.637874
2555,194,2023-02-10,127,190,354,164,2025-07-23 23:42:38.638846
2556,671,2024-10-18,65,274,437,163,2025-07-23 23:42:38.639827
2557,1417,2023-02-06,152,71,211,140,2025-07-23 23:42:38.640798
2558,35,2024-03-06,15,1,11,10,2025-07-23 23:42:38.641863
2559,649,2022-02-07,13,110,363,253,2025-07-23 23:42:38.642859
2560,868,2023-05-19,76,48,170,122,2025-07-23 23:42:38.643839
2561,1024,2024-09-09,155,115,136,21,2025-07-23 23:42:38.644809
2562,147,2022-05-05,55,336,341,5,2025-07-23 23:42:38.645782
2563,302,2022-09-10,179,208,488,280,2025-07-23 23:42:38.646722
2564,1404,2023-01-21,133,16,26,10,2025-07-23 23:42:38.647682
2565,615,2024-03-21,195,99,317,218,2025-07-23 23:42:38.648646
2566,351,2022-02-05,245,57,201,144,2025-07-23 23:42:38.649610
2567,1251,2024-08-26,107,338,450,112,2025-07-23 23:42:38.650593
2568,1320,2022-06-23,187,203,370,167,2025-07-23 23:42:38.651551
2569,431,2023-05-15,23,116,202,86,2025-07-23 23:42:38.652516
2570,303,2024-07-01,71,102,145,43,2025-07-23 23:42:38.653481
2571,1228,2023-10-07,53,157,233,76,2025-07-23 23:42:38.654459
2572,830,2022-06-25,27,57,96,39,2025-07-23 23:42:38.655433
2573,332,2023-07-31,225,137,153,16,2025-07-23 23:42:38.656396
2574,55,2023-03-05,38,275,422,147,2025-07-23 23:42:38.657360
2575,995,2024-08-22,196,18,298,280,2025-07-23 23:42:38.658312
2576,8,2024-02-13,221,63,78,15,2025-07-23 23:42:38.659279
2577,996,2024-02-28,248,81,234,153,2025-07-23 23:42:38.660255
2578,1097,2022-02-16,241,256,370,114,2025-07-23 23:42:38.661249
2579,573,2022-04-18,223,360,393,33,2025-07-23 23:42:38.662205
2580,532,2023-04-20,116,193,409,216,2025-07-23 23:42:38.663163
2581,1489,2024-02-11,72,161,170,9,2025-07-23 23:42:38.664138
2582,133,2022-02-27,173,37,165,128,2025-07-23 23:42:38.665107
2583,517,2023-12-06,49,176,182,6,2025-07-23 23:42:38.666054
2584,1406,2022-07-11,98,3,60,57,2025-07-23 23:42:38.667011
2585,1071,2024-03-29,116,55,322,267,2025-07-23 23:42:38.667959
2586,1405,2024-05-20,233,164,429,265,2025-07-23 23:42:38.668924
2587,1476,2023-06-27,225,120,196,76,2025-07-23 23:42:38.669882
2588,415,2023-07-31,55,404,415,11,2025-07-23 23:42:38.670858
2589,1032,2023-07-29,192,260,306,46,2025-07-23 23:42:38.671817
2590,1395,2023-10-10,64,282,378,96,2025-07-23 23:42:38.672859
2591,1082,2022-12-16,41,122,484,362,2025-07-23 23:42:38.674071
2592,18,2024-05-26,155,233,421,188,2025-07-23 23:42:38.675023
2593,441,2023-01-15,74,254,405,151,2025-07-23 23:42:38.675990
2594,1393,2023-10-13,19,202,457,255,2025-07-23 23:42:38.676928
2595,772,2022-04-02,148,177,466,289,2025-07-23 23:42:38.677896
2596,192,2023-05-16,150,83,433,350,2025-07-23 23:42:38.678866
2597,101,2022-02-11,124,49,484,435,2025-07-23 23:42:38.679848
2598,227,2022-09-11,106,80,124,44,2025-07-23 23:42:38.680841
2599,839,2024-07-20,118,121,140,19,2025-07-23 23:42:38.681825
2600,822,2022-06-28,201,94,108,14,2025-07-23 23:42:38.682802
2601,1412,2022-04-22,154,9,32,23,2025-07-23 23:42:38.683752
2602,618,2023-10-03,211,193,382,189,2025-07-23 23:42:38.684711
2603,676,2022-11-21,182,111,374,263,2025-07-23 23:42:38.685653
2604,813,2022-10-01,187,45,187,142,2025-07-23 23:42:38.686628
2605,579,2022-08-23,138,48,226,178,2025-07-23 23:42:38.687591
2606,193,2022-07-07,118,32,472,440,2025-07-23 23:42:38.688571
2607,1318,2024-09-21,205,62,96,34,2025-07-23 23:42:38.689694
2608,112,2024-11-09,74,16,189,173,2025-07-23 23:42:38.690688
2609,1048,2024-07-04,220,22,418,396,2025-07-23 23:42:38.691712
2610,1168,2023-05-02,16,209,420,211,2025-07-23 23:42:38.692694
2611,1127,2024-02-10,106,73,438,365,2025-07-23 23:42:38.693646
2612,1451,2024-06-13,131,120,299,179,2025-07-23 23:42:38.694621
2613,1297,2024-07-07,123,258,358,100,2025-07-23 23:42:38.695605
2614,614,2022-10-06,162,347,410,63,2025-07-23 23:42:38.696595
2615,1003,2024-04-04,108,193,201,8,2025-07-23 23:42:38.697575
2616,732,2024-07-11,35,11,205,194,2025-07-23 23:42:38.698538
2617,538,2023-12-17,179,47,344,297,2025-07-23 23:42:38.699491
2618,1079,2023-06-10,1,217,430,213,2025-07-23 23:42:38.700472
2619,1462,2023-04-12,54,20,40,20,2025-07-23 23:42:38.701446
2620,734,2024-03-19,55,79,488,409,2025-07-23 23:42:38.702425
2621,219,2023-09-14,44,88,183,95,2025-07-23 23:42:38.703391
2622,610,2022-02-07,32,238,280,42,2025-07-23 23:42:38.704344
2623,353,2022-12-10,176,56,72,16,2025-07-23 23:42:38.705304
2624,1017,2022-06-12,130,176,182,6,2025-07-23 23:42:38.706267
2625,940,2023-10-12,95,457,462,5,2025-07-23 23:42:38.707228
2626,989,2024-12-01,210,26,444,418,2025-07-23 23:42:38.708173
2627,547,2023-11-23,236,1,17,16,2025-07-23 23:42:38.709168
2628,1351,2024-05-30,102,7,35,28,2025-07-23 23:42:38.710157
2629,199,2022-11-12,149,109,497,388,2025-07-23 23:42:38.711134
2630,1226,2023-02-14,243,2,129,127,2025-07-23 23:42:38.712095
2631,276,2023-12-13,94,141,415,274,2025-07-23 23:42:38.713044
2632,55,2023-08-29,48,138,240,102,2025-07-23 23:42:38.714013
2633,141,2022-06-28,34,23,42,19,2025-07-23 23:42:38.714964
2634,138,2024-03-30,59,166,211,45,2025-07-23 23:42:38.715936
2635,242,2023-03-25,232,64,354,290,2025-07-23 23:42:38.716900
2636,1460,2022-10-01,132,35,51,16,2025-07-23 23:42:38.717873
2637,1397,2024-03-04,9,142,171,29,2025-07-23 23:42:38.718855
2638,803,2024-10-16,77,328,338,10,2025-07-23 23:42:38.719924
2639,739,2022-06-03,82,45,101,56,2025-07-23 23:42:38.720882
2640,869,2022-05-14,109,29,143,114,2025-07-23 23:42:38.721850
2641,339,2022-09-20,228,18,255,237,2025-07-23 23:42:38.722806
2642,1263,2024-05-10,70,146,185,39,2025-07-23 23:42:38.723784
2643,1247,2022-05-28,103,37,170,133,2025-07-23 23:42:38.724721
2644,1284,2024-12-30,95,23,56,33,2025-07-23 23:42:38.725981
2645,359,2024-10-02,79,283,359,76,2025-07-23 23:42:38.726995
2646,540,2023-09-09,65,103,267,164,2025-07-23 23:42:38.727942
2647,177,2024-12-12,33,126,397,271,2025-07-23 23:42:38.728897
2648,741,2024-05-08,118,1,323,322,2025-07-23 23:42:38.729881
2649,943,2022-06-26,11,35,244,209,2025-07-23 23:42:38.730872
2650,1161,2023-01-03,220,12,188,176,2025-07-23 23:42:38.731844
2651,40,2024-08-14,161,256,474,218,2025-07-23 23:42:38.732833
2652,312,2022-08-30,234,122,449,327,2025-07-23 23:42:38.733819
2653,1046,2023-11-15,230,78,84,6,2025-07-23 23:42:38.734920
2654,857,2023-03-03,65,142,372,230,2025-07-23 23:42:38.735897
2655,1237,2023-06-14,120,300,356,56,2025-07-23 23:42:38.737060
2656,1448,2024-08-20,168,257,484,227,2025-07-23 23:42:38.738052
2657,910,2024-08-26,220,206,265,59,2025-07-23 23:42:38.739021
2658,1465,2024-08-22,231,115,164,49,2025-07-23 23:42:38.740004
2659,755,2022-11-25,249,335,349,14,2025-07-23 23:42:38.740953
2660,556,2022-06-05,96,106,190,84,2025-07-23 23:42:38.741903
2661,612,2022-10-03,159,3,231,228,2025-07-23 23:42:38.742876
2662,1454,2023-06-03,190,104,476,372,2025-07-23 23:42:38.743867
2663,20,2022-04-04,59,59,173,114,2025-07-23 23:42:38.744849
2664,800,2022-03-15,22,149,169,20,2025-07-23 23:42:38.745966
2665,746,2024-05-22,250,112,255,143,2025-07-23 23:42:38.747068
2666,250,2022-09-21,244,136,197,61,2025-07-23 23:42:38.748128
2667,113,2024-04-09,71,50,178,128,2025-07-23 23:42:38.749147
2668,1411,2024-04-14,52,146,191,45,2025-07-23 23:42:38.750081
2669,823,2023-05-03,107,7,325,318,2025-07-23 23:42:38.751069
2670,738,2024-11-27,120,374,403,29,2025-07-23 23:42:38.752015
2671,957,2022-04-26,204,174,230,56,2025-07-23 23:42:38.752964
2672,95,2023-01-28,133,202,444,242,2025-07-23 23:42:38.753907
2673,63,2024-02-22,207,159,249,90,2025-07-23 23:42:38.754863
2674,651,2023-02-04,187,34,91,57,2025-07-23 23:42:38.755829
2675,11,2022-03-10,204,26,80,54,2025-07-23 23:42:38.756800
2676,944,2023-06-17,232,136,180,44,2025-07-23 23:42:38.757784
2677,51,2024-05-11,217,275,396,121,2025-07-23 23:42:38.758732
2678,464,2023-07-05,144,37,46,9,2025-07-23 23:42:38.759886
2679,257,2022-09-24,223,0,451,451,2025-07-23 23:42:38.761120
2680,160,2022-03-23,177,55,291,236,2025-07-23 23:42:38.762108
2681,219,2022-05-03,196,114,243,129,2025-07-23 23:42:38.763103
2682,1479,2022-04-18,25,41,101,60,2025-07-23 23:42:38.764056
2683,49,2022-10-19,211,272,402,130,2025-07-23 23:42:38.765019
2684,1298,2023-09-18,170,380,386,6,2025-07-23 23:42:38.765992
2685,597,2023-01-17,85,95,497,402,2025-07-23 23:42:38.767027
2686,396,2024-12-18,93,61,234,173,2025-07-23 23:42:38.767998
2687,313,2022-08-27,78,16,330,314,2025-07-23 23:42:38.768951
2688,539,2023-12-02,138,5,177,172,2025-07-23 23:42:38.769885
2689,1069,2024-10-27,68,89,156,67,2025-07-23 23:42:38.770869
2690,1345,2024-05-21,159,3,482,479,2025-07-23 23:42:38.771862
2691,713,2024-01-04,177,51,175,124,2025-07-23 23:42:38.772832
2692,1134,2024-08-10,218,267,294,27,2025-07-23 23:42:38.773808
2693,1495,2023-04-13,225,67,460,393,2025-07-23 23:42:38.774752
2694,100,2022-08-28,231,68,401,333,2025-07-23 23:42:38.775739
2695,461,2024-04-12,77,250,292,42,2025-07-23 23:42:38.776691
2696,1047,2024-08-03,101,311,469,158,2025-07-23 23:42:38.777656
2697,741,2024-03-05,133,16,271,255,2025-07-23 23:42:38.778629
2698,1019,2023-01-08,34,40,47,7,2025-07-23 23:42:38.779612
2699,257,2023-07-16,57,57,77,20,2025-07-23 23:42:38.780574
2700,1061,2023-08-22,150,25,298,273,2025-07-23 23:42:38.781531
2701,257,2023-01-23,106,67,312,245,2025-07-23 23:42:38.782495
2702,367,2024-10-21,63,187,406,219,2025-07-23 23:42:38.783468
2703,164,2024-10-04,25,327,488,161,2025-07-23 23:42:38.784449
2704,868,2023-10-30,83,73,439,366,2025-07-23 23:42:38.785413
2705,280,2024-04-05,86,246,260,14,2025-07-23 23:42:38.786368
2706,739,2022-01-29,145,132,332,200,2025-07-23 23:42:38.787337
2707,751,2024-05-17,143,146,331,185,2025-07-23 23:42:38.788275
2708,576,2022-05-20,126,192,307,115,2025-07-23 23:42:38.789247
2709,743,2024-11-01,105,38,137,99,2025-07-23 23:42:38.790200
2710,1464,2024-08-22,116,118,371,253,2025-07-23 23:42:38.791234
2711,658,2022-06-03,25,50,401,351,2025-07-23 23:42:38.792181
2712,665,2023-04-28,235,151,193,42,2025-07-23 23:42:38.793169
2713,350,2022-09-09,190,42,144,102,2025-07-23 23:42:38.794137
2714,143,2022-09-21,14,195,256,61,2025-07-23 23:42:38.795102
2715,509,2024-02-19,198,84,172,88,2025-07-23 23:42:38.796072
2716,1299,2022-05-01,186,170,354,184,2025-07-23 23:42:38.797009
2717,330,2022-10-01,220,387,442,55,2025-07-23 23:42:38.797923
2718,819,2022-11-15,181,278,420,142,2025-07-23 23:42:38.798883
2719,1351,2024-05-11,9,223,438,215,2025-07-23 23:42:38.800222
2720,1479,2024-05-30,91,256,285,29,2025-07-23 23:42:38.801376
2721,242,2024-02-23,168,17,344,327,2025-07-23 23:42:38.802443
2722,116,2022-10-17,185,369,492,123,2025-07-23 23:42:38.803407
2723,68,2024-05-04,224,111,178,67,2025-07-23 23:42:38.804363
2724,166,2024-09-23,121,3,11,8,2025-07-23 23:42:38.805311
2725,1145,2022-03-15,92,60,142,82,2025-07-23 23:42:38.806442
2726,1093,2024-08-17,128,106,135,29,2025-07-23 23:42:38.807524
2727,58,2022-05-31,164,114,181,67,2025-07-23 23:42:38.808599
2728,29,2022-02-06,246,113,152,39,2025-07-23 23:42:38.809775
2729,483,2022-02-19,107,229,402,173,2025-07-23 23:42:38.810809
2730,45,2023-07-29,128,19,73,54,2025-07-23 23:42:38.811796
2731,709,2022-05-08,222,66,183,117,2025-07-23 23:42:38.812733
2732,1414,2023-11-24,79,198,417,219,2025-07-23 23:42:38.813697
2733,262,2024-01-31,154,16,36,20,2025-07-23 23:42:38.814684
2734,417,2024-01-07,230,152,237,85,2025-07-23 23:42:38.815640
2735,1496,2023-09-01,220,197,309,112,2025-07-23 23:42:38.816654
2736,578,2022-12-13,166,50,78,28,2025-07-23 23:42:38.817605
2737,937,2022-01-31,232,125,479,354,2025-07-23 23:42:38.818591
2738,907,2022-07-21,83,5,183,178,2025-07-23 23:42:38.819548
2739,1043,2023-05-14,53,121,132,11,2025-07-23 23:42:38.820492
2740,1119,2022-07-02,155,67,129,62,2025-07-23 23:42:38.821454
2741,1069,2024-03-26,14,8,22,14,2025-07-23 23:42:38.822899
2742,743,2022-02-25,4,64,442,378,2025-07-23 23:42:38.824069
2743,1356,2024-07-16,73,176,450,274,2025-07-23 23:42:38.824998
2744,375,2022-11-05,53,300,377,77,2025-07-23 23:42:38.825950
2745,151,2022-07-24,116,174,400,226,2025-07-23 23:42:38.826900
2746,866,2022-07-26,201,27,434,407,2025-07-23 23:42:38.827854
2747,1126,2023-05-08,74,227,374,147,2025-07-23 23:42:38.828831
2748,1237,2022-10-07,156,15,185,170,2025-07-23 23:42:38.829780
2749,291,2022-09-05,247,231,290,59,2025-07-23 23:42:38.830947
2750,84,2022-06-10,45,375,479,104,2025-07-23 23:42:38.831927
2751,159,2024-04-20,197,42,340,298,2025-07-23 23:42:38.832887
2752,1283,2024-07-31,170,26,114,88,2025-07-23 23:42:38.833866
2753,1175,2022-02-19,166,133,464,331,2025-07-23 23:42:38.834849
2754,59,2023-11-03,82,31,345,314,2025-07-23 23:42:38.835813
2755,77,2024-10-12,91,3,71,68,2025-07-23 23:42:38.836805
2756,1452,2024-09-19,244,80,103,23,2025-07-23 23:42:38.837752
2757,694,2023-02-17,48,221,360,139,2025-07-23 23:42:38.838796
2758,144,2022-10-25,85,89,248,159,2025-07-23 23:42:38.839948
2759,1306,2022-01-06,198,403,483,80,2025-07-23 23:42:38.840921
2760,893,2022-06-18,23,125,154,29,2025-07-23 23:42:38.841870
2761,631,2022-03-25,55,13,59,46,2025-07-23 23:42:38.842850
2762,297,2023-03-20,212,79,164,85,2025-07-23 23:42:38.843832
2763,378,2022-11-26,10,7,79,72,2025-07-23 23:42:38.844842
2764,268,2022-08-31,24,59,490,431,2025-07-23 23:42:38.845863
2765,1413,2023-12-12,178,5,14,9,2025-07-23 23:42:38.846858
2766,200,2024-01-15,94,26,53,27,2025-07-23 23:42:38.847823
2767,514,2023-06-08,51,73,148,75,2025-07-23 23:42:38.848872
2768,907,2023-11-05,102,35,337,302,2025-07-23 23:42:38.849845
2769,110,2022-08-22,98,312,344,32,2025-07-23 23:42:38.850864
2770,942,2022-08-22,73,23,40,17,2025-07-23 23:42:38.852041
2771,363,2024-10-16,9,34,247,213,2025-07-23 23:42:38.853040
2772,471,2023-12-16,127,16,106,90,2025-07-23 23:42:38.854003
2773,965,2024-07-19,206,78,342,264,2025-07-23 23:42:38.854963
2774,1160,2024-11-28,37,85,470,385,2025-07-23 23:42:38.855879
2775,1125,2022-07-13,25,57,126,69,2025-07-23 23:42:38.856848
2776,1263,2022-09-08,245,123,429,306,2025-07-23 23:42:38.857807
2777,639,2023-10-14,65,301,400,99,2025-07-23 23:42:38.858747
2778,967,2023-03-07,33,19,95,76,2025-07-23 23:42:38.859699
2779,1383,2024-06-01,37,15,326,311,2025-07-23 23:42:38.860642
2780,180,2022-06-04,17,234,311,77,2025-07-23 23:42:38.861607
2781,350,2022-04-21,57,42,254,212,2025-07-23 23:42:38.862575
2782,63,2024-10-07,92,29,48,19,2025-07-23 23:42:38.863517
2783,969,2023-07-11,69,55,232,177,2025-07-23 23:42:38.864466
2784,958,2024-05-12,137,65,133,68,2025-07-23 23:42:38.865431
2785,1121,2023-04-20,235,246,274,28,2025-07-23 23:42:38.866377
2786,557,2024-12-29,142,136,149,13,2025-07-23 23:42:38.867314
2787,1441,2023-09-18,184,234,306,72,2025-07-23 23:42:38.868267
2788,424,2022-02-05,101,46,184,138,2025-07-23 23:42:38.869220
2789,674,2023-06-19,245,63,461,398,2025-07-23 23:42:38.870166
2790,1183,2024-03-17,31,6,64,58,2025-07-23 23:42:38.871124
2791,1010,2024-01-25,197,137,203,66,2025-07-23 23:42:38.872063
2792,30,2022-10-21,76,83,164,81,2025-07-23 23:42:38.873006
2793,226,2023-01-26,159,191,300,109,2025-07-23 23:42:38.873954
2794,1119,2024-07-31,15,24,155,131,2025-07-23 23:42:38.874889
2795,913,2022-07-06,168,36,104,68,2025-07-23 23:42:38.875832
2796,214,2023-05-05,102,182,195,13,2025-07-23 23:42:38.876753
2797,1348,2022-10-31,69,137,399,262,2025-07-23 23:42:38.878205
2798,647,2022-01-22,153,106,301,195,2025-07-23 23:42:38.879448
2799,1082,2022-05-05,144,363,446,83,2025-07-23 23:42:38.880665
2800,1456,2024-07-30,198,318,464,146,2025-07-23 23:42:38.881831
2801,497,2023-01-20,154,73,362,289,2025-07-23 23:42:38.883025
2802,275,2023-11-11,27,89,401,312,2025-07-23 23:42:38.884202
2803,797,2023-06-27,172,61,91,30,2025-07-23 23:42:38.885381
2804,445,2023-07-18,237,3,11,8,2025-07-23 23:42:38.886524
2805,1140,2023-08-24,35,87,401,314,2025-07-23 23:42:38.887629
2806,47,2022-02-10,144,29,266,237,2025-07-23 23:42:38.888817
2807,108,2022-11-17,124,450,459,9,2025-07-23 23:42:38.890009
2808,1011,2024-04-29,213,220,352,132,2025-07-23 23:42:38.891142
2809,293,2022-12-01,153,198,422,224,2025-07-23 23:42:38.892276
2810,769,2024-09-05,172,27,108,81,2025-07-23 23:42:38.893425
2811,1020,2024-02-23,226,221,389,168,2025-07-23 23:42:38.894580
2812,272,2024-11-13,47,86,361,275,2025-07-23 23:42:38.895838
2813,957,2024-05-23,223,0,51,51,2025-07-23 23:42:38.897018
2814,52,2022-09-10,39,310,353,43,2025-07-23 23:42:38.898144
2815,919,2024-05-16,211,62,175,113,2025-07-23 23:42:38.899264
2816,284,2023-02-12,30,93,105,12,2025-07-23 23:42:38.900412
2817,634,2022-07-02,8,318,357,39,2025-07-23 23:42:38.901589
2818,716,2023-04-26,11,316,407,91,2025-07-23 23:42:38.902836
2819,343,2023-05-03,2,79,465,386,2025-07-23 23:42:38.904082
2820,1123,2022-06-18,142,334,396,62,2025-07-23 23:42:38.905465
2821,269,2022-03-08,215,281,332,51,2025-07-23 23:42:38.906718
2822,517,2024-04-12,12,90,204,114,2025-07-23 23:42:38.907948
2823,387,2024-09-15,33,332,386,54,2025-07-23 23:42:38.908970
2824,53,2024-02-17,124,208,408,200,2025-07-23 23:42:38.909989
2825,150,2024-01-11,229,398,459,61,2025-07-23 23:42:38.911060
2826,1479,2022-08-22,171,61,131,70,2025-07-23 23:42:38.912124
2827,1321,2024-04-23,111,439,469,30,2025-07-23 23:42:38.913255
2828,969,2022-03-14,113,10,105,95,2025-07-23 23:42:38.914267
2829,504,2024-07-18,166,46,232,186,2025-07-23 23:42:38.915244
2830,436,2022-05-31,18,45,56,11,2025-07-23 23:42:38.916365
2831,482,2022-06-11,37,33,48,15,2025-07-23 23:42:38.917437
2832,1226,2022-04-23,204,108,385,277,2025-07-23 23:42:38.918507
2833,940,2022-03-18,184,162,250,88,2025-07-23 23:42:38.919561
2834,1026,2024-05-06,161,2,119,117,2025-07-23 23:42:38.920693
2835,931,2023-09-12,199,44,163,119,2025-07-23 23:42:38.921701
2836,132,2023-04-07,80,24,474,450,2025-07-23 23:42:38.922839
2837,357,2023-05-21,211,232,439,207,2025-07-23 23:42:38.923881
2838,258,2024-06-12,211,36,120,84,2025-07-23 23:42:38.924918
2839,653,2024-04-17,72,26,216,190,2025-07-23 23:42:38.925972
2840,459,2023-11-15,93,1,26,25,2025-07-23 23:42:38.926989
2841,139,2023-11-16,194,70,125,55,2025-07-23 23:42:38.928051
2842,1016,2022-12-07,62,201,226,25,2025-07-23 23:42:38.929178
2843,616,2023-04-11,25,9,92,83,2025-07-23 23:42:38.930204
2844,1464,2024-02-14,119,122,498,376,2025-07-23 23:42:38.931300
2845,763,2023-10-20,125,68,261,193,2025-07-23 23:42:38.932365
2846,1387,2022-02-12,202,47,252,205,2025-07-23 23:42:38.933309
2847,924,2024-04-02,18,208,408,200,2025-07-23 23:42:38.934421
2848,719,2024-02-05,195,50,261,211,2025-07-23 23:42:38.935523
2849,217,2022-02-13,73,7,45,38,2025-07-23 23:42:38.936709
2850,1221,2022-08-11,132,64,366,302,2025-07-23 23:42:38.937717
2851,612,2022-04-15,239,49,125,76,2025-07-23 23:42:38.938804
2852,547,2023-01-28,36,365,473,108,2025-07-23 23:42:38.939789
2853,743,2022-11-30,49,396,462,66,2025-07-23 23:42:38.940730
2854,561,2024-01-26,226,23,29,6,2025-07-23 23:42:38.941712
2855,837,2023-06-25,196,96,353,257,2025-07-23 23:42:38.942674
2856,545,2024-05-24,221,52,91,39,2025-07-23 23:42:38.943634
2857,744,2024-04-27,82,316,381,65,2025-07-23 23:42:38.944585
2858,1459,2024-01-10,85,6,131,125,2025-07-23 23:42:38.945711
2859,385,2024-04-18,222,113,159,46,2025-07-23 23:42:38.946856
2860,722,2023-11-14,225,103,186,83,2025-07-23 23:42:38.947882
2861,1207,2023-05-22,71,274,313,39,2025-07-23 23:42:38.948893
2862,1300,2024-05-16,248,56,317,261,2025-07-23 23:42:38.949871
2863,1393,2023-05-06,215,144,280,136,2025-07-23 23:42:38.951026
2864,137,2024-02-03,42,199,382,183,2025-07-23 23:42:38.952098
2865,1033,2023-02-09,170,64,143,79,2025-07-23 23:42:38.953089
2866,1067,2023-03-07,145,379,447,68,2025-07-23 23:42:38.954057
2867,178,2022-03-18,13,125,325,200,2025-07-23 23:42:38.955018
2868,1336,2023-05-22,44,363,465,102,2025-07-23 23:42:38.955972
2869,1351,2022-10-10,80,77,84,7,2025-07-23 23:42:38.956907
2870,541,2022-04-07,180,106,500,394,2025-07-23 23:42:38.957873
2871,869,2023-11-27,29,189,375,186,2025-07-23 23:42:38.958865
2872,521,2022-10-12,228,1,56,55,2025-07-23 23:42:38.959859
2873,56,2024-07-10,10,34,375,341,2025-07-23 23:42:38.960839
2874,1349,2023-06-25,80,174,392,218,2025-07-23 23:42:38.961844
2875,985,2024-02-09,35,44,299,255,2025-07-23 23:42:38.962823
2876,749,2023-01-23,189,169,281,112,2025-07-23 23:42:38.963794
2877,372,2022-08-13,170,265,496,231,2025-07-23 23:42:38.964739
2878,1393,2024-10-18,168,134,458,324,2025-07-23 23:42:38.965697
2879,373,2024-06-05,7,297,364,67,2025-07-23 23:42:38.966643
2880,1046,2024-04-09,151,84,193,109,2025-07-23 23:42:38.967639
2881,1360,2024-07-11,146,130,469,339,2025-07-23 23:42:38.968593
2882,459,2024-04-08,29,34,349,315,2025-07-23 23:42:38.969560
2883,876,2023-05-02,202,65,71,6,2025-07-23 23:42:38.970502
2884,1406,2023-07-07,18,111,118,7,2025-07-23 23:42:38.971463
2885,865,2022-06-14,19,92,108,16,2025-07-23 23:42:38.972440
2886,1160,2023-09-21,139,252,260,8,2025-07-23 23:42:38.973407
2887,833,2024-10-15,162,271,492,221,2025-07-23 23:42:38.974359
2888,806,2022-01-21,60,4,24,20,2025-07-23 23:42:38.975307
2889,823,2024-12-24,146,120,201,81,2025-07-23 23:42:38.976269
2890,1195,2023-01-31,116,277,484,207,2025-07-23 23:42:38.977225
2891,835,2022-06-20,69,309,431,122,2025-07-23 23:42:38.978177
2892,77,2023-07-11,228,310,462,152,2025-07-23 23:42:38.979140
2893,383,2024-01-14,17,18,73,55,2025-07-23 23:42:38.980108
2894,994,2023-09-18,176,88,335,247,2025-07-23 23:42:38.981069
2895,273,2022-06-16,140,59,111,52,2025-07-23 23:42:38.982019
2896,1144,2022-07-24,44,8,99,91,2025-07-23 23:42:38.982961
2897,50,2024-09-09,140,411,470,59,2025-07-23 23:42:38.983884
2898,1054,2024-09-21,157,0,16,16,2025-07-23 23:42:38.984843
2899,13,2022-02-18,93,77,259,182,2025-07-23 23:42:38.985794
2900,337,2024-05-10,130,108,386,278,2025-07-23 23:42:38.986753
2901,197,2022-07-10,2,204,361,157,2025-07-23 23:42:38.987733
2902,1122,2024-12-04,125,50,79,29,2025-07-23 23:42:38.988698
2903,544,2024-12-20,95,44,282,238,2025-07-23 23:42:38.989616
2904,438,2024-01-14,229,204,286,82,2025-07-23 23:42:38.990563
2905,79,2024-01-20,76,36,105,69,2025-07-23 23:42:38.991505
2906,360,2023-12-04,173,66,175,109,2025-07-23 23:42:38.992456
2907,735,2023-02-03,177,224,479,255,2025-07-23 23:42:38.993422
2908,1498,2023-07-18,134,264,306,42,2025-07-23 23:42:38.994370
2909,1272,2022-12-04,115,19,78,59,2025-07-23 23:42:38.995311
2910,672,2023-02-13,63,1,117,116,2025-07-23 23:42:38.996260
2911,1457,2022-05-10,108,146,386,240,2025-07-23 23:42:38.997205
2912,55,2022-06-20,148,46,220,174,2025-07-23 23:42:38.998161
2913,266,2022-03-21,1,125,218,93,2025-07-23 23:42:38.999122
2914,1167,2023-09-01,226,22,30,8,2025-07-23 23:42:39.000079
2915,1158,2024-03-22,136,91,112,21,2025-07-23 23:42:39.000997
2916,342,2024-11-06,194,71,96,25,2025-07-23 23:42:39.001935
2917,533,2022-12-30,170,110,244,134,2025-07-23 23:42:39.002863
2918,385,2023-10-19,228,88,159,71,2025-07-23 23:42:39.003808
2919,1490,2022-05-21,45,90,123,33,2025-07-23 23:42:39.005009
2920,494,2023-04-22,195,427,460,33,2025-07-23 23:42:39.006156
2921,458,2023-10-02,126,332,418,86,2025-07-23 23:42:39.007521
2922,1405,2024-05-23,68,131,258,127,2025-07-23 23:42:39.008745
2923,511,2024-11-20,15,101,359,258,2025-07-23 23:42:39.009981
2924,443,2023-08-27,7,17,33,16,2025-07-23 23:42:39.011156
2925,108,2023-04-30,210,102,426,324,2025-07-23 23:42:39.012295
2926,954,2023-06-26,82,24,34,10,2025-07-23 23:42:39.013461
2927,1386,2023-11-15,103,157,276,119,2025-07-23 23:42:39.014629
2928,531,2024-11-05,175,25,61,36,2025-07-23 23:42:39.015869
2929,664,2023-08-27,52,281,354,73,2025-07-23 23:42:39.016949
2930,578,2022-11-24,139,301,397,96,2025-07-23 23:42:39.017924
2931,854,2022-05-01,231,91,278,187,2025-07-23 23:42:39.018876
2932,307,2024-04-07,50,64,97,33,2025-07-23 23:42:39.019867
2933,458,2023-12-09,25,103,158,55,2025-07-23 23:42:39.020869
2934,846,2024-12-01,95,204,500,296,2025-07-23 23:42:39.021874
2935,840,2022-08-17,46,294,334,40,2025-07-23 23:42:39.022887
2936,677,2022-03-25,210,24,29,5,2025-07-23 23:42:39.023890
2937,136,2023-02-24,95,38,115,77,2025-07-23 23:42:39.024873
2938,559,2022-07-25,6,4,18,14,2025-07-23 23:42:39.025861
2939,959,2024-08-24,119,118,132,14,2025-07-23 23:42:39.026846
2940,1241,2022-10-30,72,175,183,8,2025-07-23 23:42:39.027821
2941,164,2022-11-08,81,208,455,247,2025-07-23 23:42:39.028812
2942,1130,2024-08-31,184,23,54,31,2025-07-23 23:42:39.029778
2943,170,2024-12-05,187,12,211,199,2025-07-23 23:42:39.030725
2944,1487,2022-08-07,203,246,265,19,2025-07-23 23:42:39.031678
2945,525,2024-10-15,91,124,307,183,2025-07-23 23:42:39.032720
2946,619,2022-12-23,156,123,349,226,2025-07-23 23:42:39.033813
2947,56,2024-05-12,209,363,406,43,2025-07-23 23:42:39.034938
2948,754,2022-04-24,236,94,243,149,2025-07-23 23:42:39.035981
2949,897,2022-07-01,93,213,452,239,2025-07-23 23:42:39.037067
2950,1126,2022-02-25,133,57,188,131,2025-07-23 23:42:39.039526
2951,171,2023-05-07,247,293,350,57,2025-07-23 23:42:39.040631
2952,1418,2024-02-29,235,1,57,56,2025-07-23 23:42:39.041728
2953,34,2024-08-07,26,85,427,342,2025-07-23 23:42:39.042833
2954,1135,2022-02-22,206,211,308,97,2025-07-23 23:42:39.044025
2955,1058,2023-03-01,195,168,281,113,2025-07-23 23:42:39.045198
2956,344,2023-01-19,20,27,160,133,2025-07-23 23:42:39.046511
2957,616,2022-09-11,237,371,423,52,2025-07-23 23:42:39.047699
2958,189,2022-07-03,249,73,340,267,2025-07-23 23:42:39.048901
2959,527,2024-10-11,211,228,484,256,2025-07-23 23:42:39.050074
2960,1274,2022-03-07,96,178,383,205,2025-07-23 23:42:39.051230
2961,155,2024-04-17,46,156,173,17,2025-07-23 23:42:39.052413
2962,1473,2023-12-14,131,241,313,72,2025-07-23 23:42:39.053573
2963,1336,2022-06-02,222,120,349,229,2025-07-23 23:42:39.054786
2964,1115,2022-10-19,37,161,181,20,2025-07-23 23:42:39.055957
2965,624,2023-05-21,182,113,314,201,2025-07-23 23:42:39.057222
2966,778,2022-01-07,5,297,331,34,2025-07-23 23:42:39.058492
2967,1456,2023-07-21,37,203,417,214,2025-07-23 23:42:39.059749
2968,1200,2022-03-01,75,45,193,148,2025-07-23 23:42:39.061033
2969,811,2022-05-08,228,58,347,289,2025-07-23 23:42:39.062380
2970,182,2024-09-13,138,268,428,160,2025-07-23 23:42:39.063960
2971,163,2022-01-03,86,133,332,199,2025-07-23 23:42:39.065258
2972,851,2022-10-13,221,304,435,131,2025-07-23 23:42:39.066546
2973,1014,2023-10-11,117,277,354,77,2025-07-23 23:42:39.067857
2974,596,2022-02-17,87,342,471,129,2025-07-23 23:42:39.069144
2975,911,2022-08-04,140,104,389,285,2025-07-23 23:42:39.070327
2976,666,2024-02-20,123,91,170,79,2025-07-23 23:42:39.071517
2977,912,2024-08-03,53,117,262,145,2025-07-23 23:42:39.072667
2978,1235,2022-09-03,80,52,390,338,2025-07-23 23:42:39.073666
2979,1153,2023-01-28,46,207,279,72,2025-07-23 23:42:39.074632
2980,1422,2022-12-02,117,16,44,28,2025-07-23 23:42:39.075611
2981,1421,2023-03-20,172,160,400,240,2025-07-23 23:42:39.076585
2982,936,2023-11-11,118,102,302,200,2025-07-23 23:42:39.077562
2983,634,2024-09-14,106,97,103,6,2025-07-23 23:42:39.078701
2984,1049,2023-04-21,74,218,321,103,2025-07-23 23:42:39.079729
2985,466,2022-04-16,153,26,292,266,2025-07-23 23:42:39.080860
2986,264,2022-12-16,131,37,65,28,2025-07-23 23:42:39.082490
2987,1410,2023-10-02,169,10,34,24,2025-07-23 23:42:39.083631
2988,504,2023-12-27,129,96,237,141,2025-07-23 23:42:39.084922
2989,874,2022-10-15,119,115,409,294,2025-07-23 23:42:39.085943
2990,1069,2024-07-17,20,66,109,43,2025-07-23 23:42:39.086912
2991,808,2023-06-18,127,219,388,169,2025-07-23 23:42:39.087881
2992,53,2024-08-24,18,359,485,126,2025-07-23 23:42:39.088912
2993,1183,2023-11-21,38,73,185,112,2025-07-23 23:42:39.089862
2994,147,2024-10-10,149,39,47,8,2025-07-23 23:42:39.090866
2995,662,2024-09-01,214,15,20,5,2025-07-23 23:42:39.092162
2996,648,2022-08-06,230,73,367,294,2025-07-23 23:42:39.093174
2997,786,2022-09-06,158,12,100,88,2025-07-23 23:42:39.094163
2998,1182,2024-12-03,214,259,270,11,2025-07-23 23:42:39.095149
2999,295,2023-11-21,52,377,437,60,2025-07-23 23:42:39.096130
3000,1370,2022-07-13,32,2,56,54,2025-07-23 23:42:39.097519
